detect_date,oil,probable_oil,possible_oil,other,wind,oil_other,iso3
2017-01-01,1,0,0,0,0,1,ABW
2017-01-01,58,0,1,0,0,58,AGO
2017-01-01,525,1,1,9,0,534,ARE
2017-01-01,0,0,1,0,0,0,ASM
2017-01-01,0,0,1,0,0,0,ATG
2017-01-01,59,3,24,33,0,92,AUS
2017-01-01,0,0,1,5,236,5,BEL
2017-01-01,10,0,0,0,0,10,BEN
2017-01-01,0,0,1,0,0,0,BES
2017-01-01,3,2,0,0,0,3,BGD
2017-01-01,1,0,0,0,0,1,BGR
2017-01-01,3,0,0,0,0,3,BHR
2017-01-01,0,0,2,2,0,2,BHS
2017-01-01,137,8,6,9,0,146,BRA
2017-01-01,118,1,0,0,0,118,BRN
2017-01-01,3,0,7,2,0,5,CAN
2017-01-01,0,0,1,1,0,1,CHL
2017-01-01,250,31,75,150,506,400,CHN
2017-01-01,12,0,0,0,0,12,CIV
2017-01-01,71,0,0,0,0,71,CMR
2017-01-01,18,1,0,0,0,18,COD
2017-01-01,12,3,2,0,0,12,COL
2017-01-01,2,0,4,1,0,3,CUB
2017-01-01,21,15,2,28,1166,49,DEU
2017-01-01,0,0,1,0,0,0,DJI
2017-01-01,0,0,1,0,0,0,DMA
2017-01-01,13,2,1,13,463,26,DNK
2017-01-01,0,0,2,0,0,0,DOM
2017-01-01,0,0,4,0,0,0,DZA
2017-01-01,9,1,3,0,0,9,ECU
2017-01-01,160,7,0,4,0,164,EGY
2017-01-01,0,0,2,0,0,0,ERI
2017-01-01,3,9,0,6,0,9,ESP
2017-01-01,0,0,1,1,0,1,EST
2017-01-01,0,0,0,33,1,33,FIN
2017-01-01,0,0,1,16,0,16,FRA
2017-01-01,100,0,0,0,0,100,GAB
2017-01-01,172,8,3,17,1797,189,GBR
2017-01-01,1,0,0,1,0,2,GEO
2017-01-01,2,0,3,1,0,3,GHA
2017-01-01,0,0,1,0,0,0,GIN
2017-01-01,0,0,1,0,0,0,GMB
2017-01-01,0,0,1,6,0,6,GNB
2017-01-01,13,0,0,0,0,13,GNQ
2017-01-01,2,0,0,0,0,2,GRC
2017-01-01,0,0,1,1,0,1,GUF
2017-01-01,16,0,0,3,0,19,HRV
2017-01-01,310,16,34,27,0,337,IDN
2017-01-01,161,3,28,14,0,175,IND
2017-01-01,3,0,1,3,7,6,IRL
2017-01-01,152,1,0,2,0,154,IRN
2017-01-01,1,0,0,8,0,9,IRQ
2017-01-01,0,0,1,0,0,0,ISL
2017-01-01,4,0,1,0,0,4,ISR
2017-01-01,103,6,3,2,0,105,ITA
2017-01-01,0,0,0,2,0,2,JEY
2017-01-01,18,5,33,29,0,47,JPN
2017-01-01,0,0,3,0,0,0,KEN
2017-01-01,3,0,1,3,0,6,KHM
2017-01-01,4,0,56,41,1,45,KOR
2017-01-01,30,0,0,35,0,65,KWT
2017-01-01,0,0,1,0,0,0,LBN
2017-01-01,0,0,2,0,0,0,LBR
2017-01-01,11,0,2,0,0,11,LBY
2017-01-01,0,0,4,2,0,2,LKA
2017-01-01,1,0,0,0,0,1,LTU
2017-01-01,0,0,1,0,0,0,LVA
2017-01-01,0,0,1,0,0,0,MDG
2017-01-01,153,1,8,0,0,153,MEX
2017-01-01,4,1,12,4,0,8,MMR
2017-01-01,0,0,0,3,0,3,MOZ
2017-01-01,0,0,4,0,0,0,MRT
2017-01-01,180,18,59,20,0,200,MYS
2017-01-01,11,0,0,0,0,11,NAM
2017-01-01,425,2,1,0,0,425,NGA
2017-01-01,0,0,4,1,0,1,NIC
2017-01-01,106,10,1,3,292,109,NLD
2017-01-01,12,0,0,7,1,19,NOR
2017-01-01,7,0,1,3,0,10,NZL
2017-01-01,18,0,10,0,0,18,None
2017-01-01,6,0,1,0,0,6,OMN
2017-01-01,0,0,1,0,0,0,PAK
2017-01-01,0,0,5,0,0,0,PAN
2017-01-01,88,1,3,4,0,92,PER
2017-01-01,6,0,7,3,0,9,PHL
2017-01-01,3,0,0,1,0,4,PNG
2017-01-01,9,3,0,4,3,13,POL
2017-01-01,0,0,1,0,0,0,PRI
2017-01-01,0,0,3,4,0,4,PRK
2017-01-01,0,0,1,0,0,0,PRT
2017-01-01,166,0,3,0,0,166,QAT
2017-01-01,8,0,0,0,0,8,ROU
2017-01-01,9,2,3,2,0,11,RUS
2017-01-01,620,25,6,1,0,621,SAU
2017-01-01,1,0,3,0,0,1,SDN
2017-01-01,1,0,0,0,0,1,SEN
2017-01-01,0,0,0,4,0,4,SLE
2017-01-01,0,0,2,1,0,1,SOM
2017-01-01,0,0,1,40,73,40,SWE
2017-01-01,2,0,0,0,0,2,TGO
2017-01-01,322,0,15,30,0,352,THA
2017-01-01,72,0,0,0,0,72,TTO
2017-01-01,15,11,2,1,0,16,TUN
2017-01-01,5,0,9,32,0,37,TUR
2017-01-01,6,4,1,0,2,6,TWN
2017-01-01,2,0,0,0,0,2,TZA
2017-01-01,16,3,3,9,0,25,UKR
2017-01-01,0,0,1,0,0,0,URY
2017-01-01,2239,45,1,478,5,2717,USA
2017-01-01,10,2,2,1,0,11,VEN
2017-01-01,43,0,18,109,8,152,VNM
2017-01-01,0,0,1,0,0,0,VUT
2017-01-01,2,0,6,0,0,2,YEM
2017-01-01,1,0,2,1,0,2,ZAF
2017-02-01,2,0,0,0,0,2,ABW
2017-02-01,120,1,1,0,0,120,AGO
2017-02-01,532,1,1,9,0,541,ARE
2017-02-01,0,0,1,0,0,0,ASM
2017-02-01,0,0,1,0,0,0,ATG
2017-02-01,62,3,27,41,0,103,AUS
2017-02-01,0,0,1,5,236,5,BEL
2017-02-01,10,0,0,0,0,10,BEN
2017-02-01,0,0,1,0,0,0,BES
2017-02-01,4,2,0,0,0,4,BGD
2017-02-01,1,0,0,0,0,1,BGR
2017-02-01,3,0,1,0,0,3,BHR
2017-02-01,0,0,2,2,0,2,BHS
2017-02-01,141,11,6,15,0,156,BRA
2017-02-01,119,2,0,0,0,119,BRN
2017-02-01,6,0,7,8,0,14,CAN
2017-02-01,0,0,1,1,0,1,CHL
2017-02-01,257,33,82,173,540,430,CHN
2017-02-01,12,0,0,0,0,12,CIV
2017-02-01,71,0,0,0,0,71,CMR
2017-02-01,52,1,0,0,0,52,COD
2017-02-01,61,0,0,0,0,61,COG
2017-02-01,12,3,3,0,0,12,COL
2017-02-01,2,0,4,1,0,3,CUB
2017-02-01,21,16,2,28,1169,49,DEU
2017-02-01,0,0,1,0,0,0,DJI
2017-02-01,0,0,1,0,0,0,DMA
2017-02-01,14,2,1,17,463,31,DNK
2017-02-01,0,0,2,0,0,0,DOM
2017-02-01,0,0,4,1,0,1,DZA
2017-02-01,9,1,3,0,0,9,ECU
2017-02-01,172,7,1,4,0,176,EGY
2017-02-01,0,0,2,0,0,0,ERI
2017-02-01,3,10,0,6,0,9,ESP
2017-02-01,0,0,1,1,0,1,EST
2017-02-01,0,0,0,38,1,38,FIN
2017-02-01,0,0,1,0,0,0,FJI
2017-02-01,0,0,3,22,0,22,FRA
2017-02-01,115,0,1,0,0,115,GAB
2017-02-01,182,11,3,17,1812,199,GBR
2017-02-01,1,0,0,1,0,2,GEO
2017-02-01,2,0,3,1,0,3,GHA
2017-02-01,0,0,1,0,0,0,GIN
2017-02-01,0,0,1,0,0,0,GMB
2017-02-01,0,0,1,9,0,9,GNB
2017-02-01,13,0,0,0,0,13,GNQ
2017-02-01,5,0,0,0,0,5,GRC
2017-02-01,0,0,1,1,0,1,GUF
2017-02-01,16,0,0,3,0,19,HRV
2017-02-01,409,19,42,50,0,459,IDN
2017-02-01,168,3,31,15,0,183,IND
2017-02-01,3,0,2,5,7,8,IRL
2017-02-01,159,1,0,2,0,161,IRN
2017-02-01,1,0,0,8,0,9,IRQ
2017-02-01,0,0,1,0,0,0,ISL
2017-02-01,4,0,2,0,0,4,ISR
2017-02-01,104,6,3,4,0,108,ITA
2017-02-01,0,0,0,2,0,2,JEY
2017-02-01,19,5,33,30,0,49,JPN
2017-02-01,0,0,3,0,0,0,KEN
2017-02-01,3,0,2,4,0,7,KHM
2017-02-01,4,0,59,48,1,52,KOR
2017-02-01,34,0,0,36,0,70,KWT
2017-02-01,0,0,1,0,0,0,LBN
2017-02-01,0,0,2,0,0,0,LBR
2017-02-01,12,0,2,0,0,12,LBY
2017-02-01,0,0,4,3,0,3,LKA
2017-02-01,1,0,0,0,0,1,LTU
2017-02-01,0,0,1,0,0,0,LVA
2017-02-01,0,0,1,0,0,0,MDG
2017-02-01,194,2,10,0,0,194,MEX
2017-02-01,5,1,13,5,0,10,MMR
2017-02-01,0,0,0,3,0,3,MOZ
2017-02-01,1,0,4,0,0,1,MRT
2017-02-01,258,22,72,24,0,282,MYS
2017-02-01,12,0,0,0,0,12,NAM
2017-02-01,426,2,1,1,0,427,NGA
2017-02-01,0,0,4,1,0,1,NIC
2017-02-01,111,11,1,4,292,115,NLD
2017-02-01,13,0,0,7,1,20,NOR
2017-02-01,7,0,1,4,0,11,NZL
2017-02-01,18,0,14,1,0,19,None
2017-02-01,6,0,1,0,0,6,OMN
2017-02-01,0,0,1,0,0,0,PAK
2017-02-01,0,0,5,0,0,0,PAN
2017-02-01,91,1,3,4,0,95,PER
2017-02-01,6,0,7,3,0,9,PHL
2017-02-01,3,0,1,1,0,4,PNG
2017-02-01,9,3,0,4,3,13,POL
2017-02-01,0,0,1,0,0,0,PRI
2017-02-01,0,0,3,4,0,4,PRK
2017-02-01,0,0,1,0,0,0,PRT
2017-02-01,166,0,3,0,0,166,QAT
2017-02-01,8,0,0,0,0,8,ROU
2017-02-01,10,2,3,2,0,12,RUS
2017-02-01,626,29,6,1,0,627,SAU
2017-02-01,1,0,3,0,0,1,SDN
2017-02-01,2,0,1,0,0,2,SEN
2017-02-01,0,0,0,4,0,4,SLE
2017-02-01,0,0,2,1,0,1,SOM
2017-02-01,0,1,0,0,0,0,SUR
2017-02-01,0,0,1,40,73,40,SWE
2017-02-01,2,0,0,0,0,2,TGO
2017-02-01,325,0,16,34,0,359,THA
2017-02-01,74,0,0,0,0,74,TTO
2017-02-01,16,11,2,1,0,17,TUN
2017-02-01,5,0,9,33,0,38,TUR
2017-02-01,6,4,2,0,2,6,TWN
2017-02-01,2,1,0,0,0,2,TZA
2017-02-01,17,3,3,9,0,26,UKR
2017-02-01,0,0,1,0,0,0,URY
2017-02-01,2460,49,1,521,5,2981,USA
2017-02-01,13,2,3,1,0,14,VEN
2017-02-01,43,0,19,110,8,153,VNM
2017-02-01,0,0,1,0,0,0,VUT
2017-02-01,2,0,6,0,0,2,YEM
2017-02-01,1,0,3,1,0,2,ZAF
2017-03-01,1,0,0,0,0,1,ABW
2017-03-01,121,1,1,0,0,121,AGO
2017-03-01,531,1,1,9,0,540,ARE
2017-03-01,0,0,1,0,0,0,ASM
2017-03-01,0,0,1,0,0,0,ATG
2017-03-01,66,4,24,38,0,104,AUS
2017-03-01,0,0,1,5,236,5,BEL
2017-03-01,9,0,0,0,0,9,BEN
2017-03-01,0,0,1,0,0,0,BES
2017-03-01,4,2,0,0,0,4,BGD
2017-03-01,1,0,0,0,0,1,BGR
2017-03-01,3,0,1,0,0,3,BHR
2017-03-01,0,0,2,3,0,3,BHS
2017-03-01,141,12,6,16,0,157,BRA
2017-03-01,118,2,0,0,0,118,BRN
2017-03-01,6,0,7,8,0,14,CAN
2017-03-01,0,0,1,1,0,1,CHL
2017-03-01,292,33,81,166,553,458,CHN
2017-03-01,12,0,0,0,0,12,CIV
2017-03-01,71,0,0,0,0,71,CMR
2017-03-01,54,1,0,0,0,54,COD
2017-03-01,63,0,0,0,0,63,COG
2017-03-01,11,3,3,0,0,11,COL
2017-03-01,2,0,5,1,0,3,CUB
2017-03-01,21,16,2,29,1169,50,DEU
2017-03-01,0,0,1,0,0,0,DJI
2017-03-01,0,0,1,0,0,0,DMA
2017-03-01,14,2,1,17,463,31,DNK
2017-03-01,0,0,1,0,0,0,DOM
2017-03-01,0,0,4,1,0,1,DZA
2017-03-01,9,1,3,0,0,9,ECU
2017-03-01,173,6,1,4,0,177,EGY
2017-03-01,0,0,2,0,0,0,ERI
2017-03-01,3,10,0,6,0,9,ESP
2017-03-01,0,0,1,1,0,1,EST
2017-03-01,0,0,0,40,1,40,FIN
2017-03-01,0,0,1,0,0,0,FJI
2017-03-01,0,0,3,23,0,23,FRA
2017-03-01,121,0,1,0,0,121,GAB
2017-03-01,182,11,3,15,1835,197,GBR
2017-03-01,1,0,0,1,0,2,GEO
2017-03-01,2,0,3,1,0,3,GHA
2017-03-01,0,0,1,1,0,1,GIN
2017-03-01,0,0,2,0,0,0,GMB
2017-03-01,0,0,1,10,0,10,GNB
2017-03-01,13,0,0,0,0,13,GNQ
2017-03-01,5,0,0,0,0,5,GRC
2017-03-01,0,0,1,0,0,0,GUF
2017-03-01,16,0,0,3,0,19,HRV
2017-03-01,542,26,51,64,0,606,IDN
2017-03-01,168,3,34,18,0,186,IND
2017-03-01,3,0,2,5,7,8,IRL
2017-03-01,157,2,0,2,0,159,IRN
2017-03-01,1,0,0,8,0,9,IRQ
2017-03-01,4,0,2,0,0,4,ISR
2017-03-01,104,6,3,4,0,108,ITA
2017-03-01,0,0,0,3,0,3,JEY
2017-03-01,19,7,35,26,0,45,JPN
2017-03-01,0,0,3,0,0,0,KEN
2017-03-01,3,0,2,6,0,9,KHM
2017-03-01,5,0,55,50,2,55,KOR
2017-03-01,35,0,0,33,0,68,KWT
2017-03-01,0,0,1,1,0,1,LBN
2017-03-01,0,0,1,0,0,0,LBR
2017-03-01,12,0,2,0,0,12,LBY
2017-03-01,0,0,4,3,0,3,LKA
2017-03-01,1,0,0,0,0,1,LTU
2017-03-01,0,0,1,0,0,0,LVA
2017-03-01,0,0,1,0,0,0,MDG
2017-03-01,196,1,10,0,0,196,MEX
2017-03-01,4,0,14,5,0,9,MMR
2017-03-01,0,0,0,3,0,3,MOZ
2017-03-01,1,0,4,0,0,1,MRT
2017-03-01,287,25,62,24,0,311,MYS
2017-03-01,14,0,0,0,0,14,NAM
2017-03-01,411,2,1,1,0,412,NGA
2017-03-01,0,0,3,1,0,1,NIC
2017-03-01,113,12,1,4,293,117,NLD
2017-03-01,14,0,0,7,1,21,NOR
2017-03-01,7,0,2,4,0,11,NZL
2017-03-01,18,0,14,1,0,19,None
2017-03-01,6,0,1,0,0,6,OMN
2017-03-01,0,0,1,0,0,0,PAK
2017-03-01,0,1,5,0,0,0,PAN
2017-03-01,90,1,5,4,0,94,PER
2017-03-01,7,0,6,5,0,12,PHL
2017-03-01,3,0,1,1,0,4,PNG
2017-03-01,9,3,0,5,3,14,POL
2017-03-01,0,0,1,0,0,0,PRI
2017-03-01,1,0,3,4,0,5,PRK
2017-03-01,0,0,1,0,0,0,PRT
2017-03-01,164,0,3,1,0,165,QAT
2017-03-01,8,0,0,0,0,8,ROU
2017-03-01,9,2,5,3,0,12,RUS
2017-03-01,631,28,6,1,0,632,SAU
2017-03-01,1,0,3,0,0,1,SDN
2017-03-01,2,0,1,0,0,2,SEN
2017-03-01,0,0,0,4,0,4,SLE
2017-03-01,0,0,2,1,0,1,SOM
2017-03-01,0,1,0,0,0,0,SUR
2017-03-01,0,0,1,42,73,42,SWE
2017-03-01,1,0,0,0,0,1,TGO
2017-03-01,395,0,14,35,0,430,THA
2017-03-01,74,0,0,0,0,74,TTO
2017-03-01,15,11,2,1,0,16,TUN
2017-03-01,5,0,9,33,0,38,TUR
2017-03-01,7,4,2,0,2,7,TWN
2017-03-01,2,1,0,0,0,2,TZA
2017-03-01,16,3,3,10,0,26,UKR
2017-03-01,0,0,1,0,0,0,URY
2017-03-01,2452,49,1,497,5,2949,USA
2017-03-01,13,2,3,1,0,14,VEN
2017-03-01,44,0,22,110,10,154,VNM
2017-03-01,0,0,1,0,0,0,VUT
2017-03-01,2,0,6,0,0,2,YEM
2017-03-01,1,0,3,1,0,2,ZAF
2017-04-01,1,0,0,0,0,1,ABW
2017-04-01,122,2,1,0,0,122,AGO
2017-04-01,537,1,1,10,0,547,ARE
2017-04-01,0,0,1,0,0,0,ASM
2017-04-01,0,0,1,0,0,0,ATG
2017-04-01,69,4,22,35,0,104,AUS
2017-04-01,0,0,1,5,236,5,BEL
2017-04-01,7,0,0,0,0,7,BEN
2017-04-01,0,0,1,0,0,0,BES
2017-04-01,2,2,0,0,0,2,BGD
2017-04-01,1,0,0,0,0,1,BGR
2017-04-01,4,0,1,0,0,4,BHR
2017-04-01,0,0,2,3,0,3,BHS
2017-04-01,138,12,5,14,0,152,BRA
2017-04-01,120,2,0,0,0,120,BRN
2017-04-01,6,0,7,11,0,17,CAN
2017-04-01,0,0,1,1,0,1,CHL
2017-04-01,288,31,84,167,594,455,CHN
2017-04-01,11,0,0,0,0,11,CIV
2017-04-01,71,0,0,0,0,71,CMR
2017-04-01,55,1,0,0,0,55,COD
2017-04-01,63,0,0,0,0,63,COG
2017-04-01,11,3,2,0,0,11,COL
2017-04-01,2,0,5,1,0,3,CUB
2017-04-01,21,17,2,30,1169,51,DEU
2017-04-01,1,0,1,0,0,1,DJI
2017-04-01,0,0,1,0,0,0,DMA
2017-04-01,14,2,1,18,463,32,DNK
2017-04-01,0,0,1,0,0,0,DOM
2017-04-01,0,0,4,1,0,1,DZA
2017-04-01,9,0,3,0,0,9,ECU
2017-04-01,173,6,1,4,0,177,EGY
2017-04-01,0,0,2,0,0,0,ERI
2017-04-01,3,9,0,6,0,9,ESP
2017-04-01,0,0,1,1,0,1,EST
2017-04-01,0,0,0,42,1,42,FIN
2017-04-01,0,0,1,0,0,0,FJI
2017-04-01,0,0,3,20,0,20,FRA
2017-04-01,123,0,1,0,0,123,GAB
2017-04-01,183,11,3,14,1836,197,GBR
2017-04-01,1,0,0,1,0,2,GEO
2017-04-01,3,0,3,1,0,4,GHA
2017-04-01,0,0,1,2,0,2,GIN
2017-04-01,0,0,1,0,0,0,GMB
2017-04-01,0,0,1,12,0,12,GNB
2017-04-01,13,0,0,0,0,13,GNQ
2017-04-01,5,0,0,1,0,6,GRC
2017-04-01,0,0,1,0,0,0,GUF
2017-04-01,16,0,0,3,0,19,HRV
2017-04-01,540,28,56,67,0,607,IDN
2017-04-01,165,3,35,18,0,183,IND
2017-04-01,3,0,1,4,7,7,IRL
2017-04-01,159,2,0,2,0,161,IRN
2017-04-01,1,0,0,5,0,6,IRQ
2017-04-01,4,0,1,0,0,4,ISR
2017-04-01,104,7,3,5,0,109,ITA
2017-04-01,0,0,0,2,0,2,JEY
2017-04-01,20,9,38,24,0,44,JPN
2017-04-01,0,0,3,0,0,0,KEN
2017-04-01,3,0,1,6,0,9,KHM
2017-04-01,5,0,57,49,3,54,KOR
2017-04-01,36,1,0,32,0,68,KWT
2017-04-01,0,0,1,1,0,1,LBN
2017-04-01,0,0,2,0,0,0,LBR
2017-04-01,12,0,2,0,0,12,LBY
2017-04-01,0,0,4,3,0,3,LKA
2017-04-01,1,1,0,0,0,1,LTU
2017-04-01,0,0,1,0,0,0,LVA
2017-04-01,0,0,1,0,0,0,MDG
2017-04-01,195,2,9,0,0,195,MEX
2017-04-01,4,1,13,5,0,9,MMR
2017-04-01,0,0,0,3,0,3,MOZ
2017-04-01,1,0,4,0,0,1,MRT
2017-04-01,292,26,69,29,0,321,MYS
2017-04-01,15,0,0,0,0,15,NAM
2017-04-01,397,2,1,1,0,398,NGA
2017-04-01,0,0,3,1,0,1,NIC
2017-04-01,114,14,1,4,293,118,NLD
2017-04-01,15,0,0,8,1,23,NOR
2017-04-01,7,0,2,4,0,11,NZL
2017-04-01,18,0,16,0,0,18,None
2017-04-01,6,0,1,0,0,6,OMN
2017-04-01,0,0,1,0,0,0,PAK
2017-04-01,0,1,5,0,0,0,PAN
2017-04-01,93,1,5,4,0,97,PER
2017-04-01,7,0,7,5,0,12,PHL
2017-04-01,3,0,0,1,0,4,PNG
2017-04-01,9,3,0,5,3,14,POL
2017-04-01,0,0,1,0,0,0,PRI
2017-04-01,1,0,3,4,0,5,PRK
2017-04-01,0,0,1,0,0,0,PRT
2017-04-01,165,0,3,1,0,166,QAT
2017-04-01,8,0,0,0,0,8,ROU
2017-04-01,9,2,6,3,0,12,RUS
2017-04-01,632,27,6,1,0,633,SAU
2017-04-01,1,0,3,0,0,1,SDN
2017-04-01,2,0,0,0,0,2,SEN
2017-04-01,0,0,0,15,0,15,SGP
2017-04-01,0,0,0,4,0,4,SLE
2017-04-01,0,0,2,1,0,1,SOM
2017-04-01,0,0,1,44,73,44,SWE
2017-04-01,1,0,0,0,0,1,TGO
2017-04-01,396,0,14,35,0,431,THA
2017-04-01,74,0,0,0,0,74,TTO
2017-04-01,14,11,2,1,0,15,TUN
2017-04-01,5,0,10,32,0,37,TUR
2017-04-01,7,5,2,0,2,7,TWN
2017-04-01,2,1,0,0,0,2,TZA
2017-04-01,16,3,2,10,0,26,UKR
2017-04-01,0,0,1,0,0,0,URY
2017-04-01,2451,47,2,484,5,2935,USA
2017-04-01,13,2,2,1,0,14,VEN
2017-04-01,44,0,20,110,10,154,VNM
2017-04-01,0,0,1,0,0,0,VUT
2017-04-01,3,0,7,0,0,3,YEM
2017-04-01,1,0,3,1,0,2,ZAF
2017-05-01,2,0,0,0,0,2,ABW
2017-05-01,126,2,0,0,0,126,AGO
2017-05-01,0,1,0,0,0,0,ALB
2017-05-01,537,1,1,10,0,547,ARE
2017-05-01,0,0,1,0,0,0,ASM
2017-05-01,0,0,1,0,0,0,ATG
2017-05-01,70,4,22,36,0,106,AUS
2017-05-01,0,0,1,5,236,5,BEL
2017-05-01,7,0,0,0,0,7,BEN
2017-05-01,0,0,1,0,0,0,BES
2017-05-01,1,2,0,0,0,1,BGD
2017-05-01,1,0,0,0,0,1,BGR
2017-05-01,4,0,1,0,0,4,BHR
2017-05-01,0,0,3,3,0,3,BHS
2017-05-01,139,12,6,10,0,149,BRA
2017-05-01,120,3,0,0,0,120,BRN
2017-05-01,6,0,7,18,0,24,CAN
2017-05-01,0,0,1,0,0,0,CHL
2017-05-01,276,33,84,155,621,431,CHN
2017-05-01,11,0,1,0,0,11,CIV
2017-05-01,70,0,0,0,0,70,CMR
2017-05-01,54,1,0,0,0,54,COD
2017-05-01,63,0,0,0,0,63,COG
2017-05-01,11,3,2,0,0,11,COL
2017-05-01,2,0,5,2,0,4,CUB
2017-05-01,20,17,2,30,1170,50,DEU
2017-05-01,1,0,1,0,0,1,DJI
2017-05-01,0,0,1,0,0,0,DMA
2017-05-01,15,2,1,16,460,31,DNK
2017-05-01,0,0,1,0,0,0,DOM
2017-05-01,0,0,4,1,0,1,DZA
2017-05-01,9,0,3,0,0,9,ECU
2017-05-01,175,5,1,4,0,179,EGY
2017-05-01,0,0,2,0,0,0,ERI
2017-05-01,3,9,0,6,0,9,ESP
2017-05-01,0,0,1,1,0,1,EST
2017-05-01,0,0,0,44,2,44,FIN
2017-05-01,0,0,1,0,0,0,FJI
2017-05-01,0,0,1,21,0,21,FRA
2017-05-01,121,0,1,0,0,121,GAB
2017-05-01,181,11,4,15,1856,196,GBR
2017-05-01,1,0,0,1,0,2,GEO
2017-05-01,3,0,3,1,0,4,GHA
2017-05-01,0,0,1,2,0,2,GIN
2017-05-01,0,0,1,0,0,0,GMB
2017-05-01,0,0,1,10,0,10,GNB
2017-05-01,13,0,0,0,0,13,GNQ
2017-05-01,5,0,0,1,0,6,GRC
2017-05-01,0,0,1,0,0,0,GUF
2017-05-01,16,0,0,3,0,19,HRV
2017-05-01,542,32,53,69,0,611,IDN
2017-05-01,163,1,34,14,0,177,IND
2017-05-01,3,0,1,4,7,7,IRL
2017-05-01,159,3,0,2,0,161,IRN
2017-05-01,1,0,0,5,0,6,IRQ
2017-05-01,5,0,1,0,0,5,ISR
2017-05-01,104,8,3,5,0,109,ITA
2017-05-01,0,0,0,2,0,2,JEY
2017-05-01,20,10,39,26,0,46,JPN
2017-05-01,0,0,3,0,0,0,KEN
2017-05-01,3,0,1,6,0,9,KHM
2017-05-01,5,0,56,51,3,56,KOR
2017-05-01,35,2,0,32,0,67,KWT
2017-05-01,0,0,1,1,0,1,LBN
2017-05-01,0,0,2,0,0,0,LBR
2017-05-01,12,0,2,0,0,12,LBY
2017-05-01,0,0,4,3,0,3,LKA
2017-05-01,1,1,0,0,0,1,LTU
2017-05-01,0,0,1,0,0,0,LVA
2017-05-01,0,0,2,0,0,0,MDG
2017-05-01,194,2,10,0,0,194,MEX
2017-05-01,4,2,10,4,0,8,MMR
2017-05-01,0,0,0,3,0,3,MOZ
2017-05-01,1,0,4,0,0,1,MRT
2017-05-01,295,23,74,30,0,325,MYS
2017-05-01,14,0,0,0,0,14,NAM
2017-05-01,374,2,1,1,0,375,NGA
2017-05-01,0,0,3,2,0,2,NIC
2017-05-01,117,13,1,5,294,122,NLD
2017-05-01,18,0,0,8,1,26,NOR
2017-05-01,7,0,2,4,0,11,NZL
2017-05-01,17,0,15,0,0,17,None
2017-05-01,6,0,1,0,0,6,OMN
2017-05-01,0,0,1,0,0,0,PAK
2017-05-01,0,1,5,0,0,0,PAN
2017-05-01,93,1,5,4,0,97,PER
2017-05-01,7,0,6,3,0,10,PHL
2017-05-01,3,0,0,1,0,4,PNG
2017-05-01,9,3,0,5,3,14,POL
2017-05-01,0,0,1,0,0,0,PRI
2017-05-01,1,0,3,5,0,6,PRK
2017-05-01,0,0,1,0,0,0,PRT
2017-05-01,165,0,3,1,0,166,QAT
2017-05-01,8,0,0,0,0,8,ROU
2017-05-01,9,2,5,3,0,12,RUS
2017-05-01,632,25,6,1,0,633,SAU
2017-05-01,1,0,3,0,0,1,SDN
2017-05-01,2,0,0,0,0,2,SEN
2017-05-01,0,0,0,20,0,20,SGP
2017-05-01,0,0,0,4,0,4,SLE
2017-05-01,0,0,2,1,0,1,SOM
2017-05-01,0,0,1,46,73,46,SWE
2017-05-01,1,0,0,0,0,1,TGO
2017-05-01,396,0,12,36,0,432,THA
2017-05-01,74,0,0,0,0,74,TTO
2017-05-01,14,11,2,1,0,15,TUN
2017-05-01,5,0,10,31,0,36,TUR
2017-05-01,7,5,2,0,2,7,TWN
2017-05-01,2,1,0,0,0,2,TZA
2017-05-01,16,3,2,10,0,26,UKR
2017-05-01,0,0,1,0,0,0,URY
2017-05-01,2450,44,2,475,5,2925,USA
2017-05-01,11,3,2,0,0,11,VEN
2017-05-01,45,0,15,108,10,153,VNM
2017-05-01,0,0,1,0,0,0,VUT
2017-05-01,2,0,7,1,0,3,YEM
2017-05-01,1,0,3,1,0,2,ZAF
2017-06-01,3,0,0,0,0,3,ABW
2017-06-01,251,2,0,0,0,251,AGO
2017-06-01,0,1,0,0,0,0,ALB
2017-06-01,536,2,1,11,0,547,ARE
2017-06-01,0,0,1,0,0,0,ASM
2017-06-01,0,0,1,0,0,0,ATG
2017-06-01,69,4,21,36,0,105,AUS
2017-06-01,0,0,1,5,236,5,BEL
2017-06-01,7,0,0,0,0,7,BEN
2017-06-01,0,0,1,0,0,0,BES
2017-06-01,1,2,0,0,0,1,BGD
2017-06-01,1,0,0,0,0,1,BGR
2017-06-01,4,0,1,1,0,5,BHR
2017-06-01,0,0,3,3,0,3,BHS
2017-06-01,136,13,6,11,0,147,BRA
2017-06-01,120,2,0,0,0,120,BRN
2017-06-01,6,0,6,19,0,25,CAN
2017-06-01,0,0,1,0,0,0,CHL
2017-06-01,278,28,85,161,676,439,CHN
2017-06-01,12,0,1,0,0,12,CIV
2017-06-01,68,0,0,0,0,68,CMR
2017-06-01,53,1,0,0,0,53,COD
2017-06-01,78,0,0,0,0,78,COG
2017-06-01,10,3,2,1,0,11,COL
2017-06-01,2,0,4,2,0,4,CUB
2017-06-01,20,16,2,30,1189,50,DEU
2017-06-01,1,0,1,0,0,1,DJI
2017-06-01,0,0,1,0,0,0,DMA
2017-06-01,16,2,1,16,460,32,DNK
2017-06-01,0,0,1,0,0,0,DOM
2017-06-01,0,0,4,2,0,2,DZA
2017-06-01,5,0,2,0,0,5,ECU
2017-06-01,175,5,0,4,0,179,EGY
2017-06-01,0,0,3,0,0,0,ERI
2017-06-01,3,9,0,6,0,9,ESP
2017-06-01,0,0,0,1,0,1,EST
2017-06-01,0,0,1,46,4,46,FIN
2017-06-01,0,0,1,25,0,25,FRA
2017-06-01,121,0,1,0,0,121,GAB
2017-06-01,177,11,5,15,1897,192,GBR
2017-06-01,1,0,0,0,0,1,GEO
2017-06-01,3,0,10,1,0,4,GHA
2017-06-01,0,0,1,2,0,2,GIN
2017-06-01,0,0,1,9,0,9,GNB
2017-06-01,13,0,0,0,0,13,GNQ
2017-06-01,5,0,0,0,0,5,GRC
2017-06-01,0,0,1,0,0,0,GUF
2017-06-01,16,0,0,3,0,19,HRV
2017-06-01,540,35,50,73,0,613,IDN
2017-06-01,168,1,37,11,0,179,IND
2017-06-01,3,0,2,4,7,7,IRL
2017-06-01,160,3,0,2,0,162,IRN
2017-06-01,1,0,0,5,0,6,IRQ
2017-06-01,5,0,1,0,0,5,ISR
2017-06-01,104,8,3,5,0,109,ITA
2017-06-01,0,0,0,2,0,2,JEY
2017-06-01,20,9,41,27,0,47,JPN
2017-06-01,0,0,3,0,0,0,KEN
2017-06-01,3,0,1,7,0,10,KHM
2017-06-01,5,0,57,53,3,58,KOR
2017-06-01,33,2,0,33,0,66,KWT
2017-06-01,0,0,1,0,0,0,LBN
2017-06-01,0,0,2,0,0,0,LBR
2017-06-01,11,0,2,0,0,11,LBY
2017-06-01,0,0,4,3,0,3,LKA
2017-06-01,1,0,0,0,0,1,LTU
2017-06-01,0,0,1,0,0,0,LVA
2017-06-01,0,0,2,0,0,0,MDG
2017-06-01,189,2,11,0,0,189,MEX
2017-06-01,0,0,1,0,0,0,MLT
2017-06-01,5,2,9,5,0,10,MMR
2017-06-01,0,0,0,3,0,3,MOZ
2017-06-01,1,0,4,0,0,1,MRT
2017-06-01,316,25,71,32,0,348,MYS
2017-06-01,15,0,0,0,0,15,NAM
2017-06-01,370,2,2,1,0,371,NGA
2017-06-01,0,0,2,2,0,2,NIC
2017-06-01,114,12,1,5,294,119,NLD
2017-06-01,19,0,0,9,1,28,NOR
2017-06-01,7,0,2,4,0,11,NZL
2017-06-01,17,0,13,0,0,17,None
2017-06-01,7,0,2,0,0,7,OMN
2017-06-01,0,0,1,0,0,0,PAK
2017-06-01,0,1,2,0,0,0,PAN
2017-06-01,93,1,4,4,0,97,PER
2017-06-01,7,0,5,8,0,15,PHL
2017-06-01,3,0,0,1,0,4,PNG
2017-06-01,9,3,0,5,3,14,POL
2017-06-01,0,0,1,0,0,0,PRI
2017-06-01,1,0,3,5,0,6,PRK
2017-06-01,0,0,1,0,0,0,PRT
2017-06-01,165,0,3,1,0,166,QAT
2017-06-01,8,0,0,0,0,8,ROU
2017-06-01,9,2,6,4,0,13,RUS
2017-06-01,640,25,7,1,0,641,SAU
2017-06-01,1,0,3,0,0,1,SDN
2017-06-01,2,0,0,0,0,2,SEN
2017-06-01,0,0,0,21,0,21,SGP
2017-06-01,0,0,0,4,0,4,SLE
2017-06-01,0,0,2,1,0,1,SOM
2017-06-01,0,0,1,0,0,0,SUR
2017-06-01,0,0,1,45,73,45,SWE
2017-06-01,1,0,0,0,0,1,TGO
2017-06-01,400,0,11,36,0,436,THA
2017-06-01,315,2,0,1,0,316,TTO
2017-06-01,15,11,2,0,0,15,TUN
2017-06-01,5,0,10,31,0,36,TUR
2017-06-01,7,5,1,0,2,7,TWN
2017-06-01,2,1,0,0,0,2,TZA
2017-06-01,16,3,2,8,0,24,UKR
2017-06-01,0,0,1,0,0,0,URY
2017-06-01,2458,40,2,468,5,2926,USA
2017-06-01,12,3,2,0,0,12,VEN
2017-06-01,43,0,15,109,8,152,VNM
2017-06-01,0,0,1,0,0,0,VUT
2017-06-01,2,0,5,1,0,3,YEM
2017-06-01,1,0,3,1,0,2,ZAF
2017-07-01,3,0,0,0,0,3,ABW
2017-07-01,247,2,0,0,0,247,AGO
2017-07-01,0,1,0,0,0,0,ALB
2017-07-01,536,2,1,11,0,547,ARE
2017-07-01,0,0,1,0,0,0,ASM
2017-07-01,0,0,1,0,0,0,ATG
2017-07-01,69,4,21,36,0,105,AUS
2017-07-01,0,0,1,5,236,5,BEL
2017-07-01,6,0,0,0,0,6,BEN
2017-07-01,0,0,1,0,0,0,BES
2017-07-01,1,3,0,0,0,1,BGD
2017-07-01,1,0,0,0,0,1,BGR
2017-07-01,3,0,1,1,0,4,BHR
2017-07-01,0,0,3,4,0,4,BHS
2017-07-01,139,13,6,11,0,150,BRA
2017-07-01,119,1,0,0,0,119,BRN
2017-07-01,6,0,8,20,0,26,CAN
2017-07-01,0,0,1,0,0,0,CHL
2017-07-01,277,27,85,160,706,437,CHN
2017-07-01,12,0,1,0,0,12,CIV
2017-07-01,61,0,0,0,0,61,CMR
2017-07-01,51,0,0,0,0,51,COD
2017-07-01,76,0,0,0,0,76,COG
2017-07-01,6,0,2,1,0,7,COL
2017-07-01,2,0,4,2,0,4,CUB
2017-07-01,20,15,2,29,1192,49,DEU
2017-07-01,1,0,1,0,0,1,DJI
2017-07-01,0,0,1,0,0,0,DMA
2017-07-01,17,2,1,16,460,33,DNK
2017-07-01,0,0,1,0,0,0,DOM
2017-07-01,0,0,4,2,0,2,DZA
2017-07-01,5,0,2,0,0,5,ECU
2017-07-01,174,5,0,4,0,178,EGY
2017-07-01,0,0,3,0,0,0,ERI
2017-07-01,3,9,0,6,0,9,ESP
2017-07-01,0,0,0,1,0,1,EST
2017-07-01,0,0,1,49,6,49,FIN
2017-07-01,0,0,1,25,0,25,FRA
2017-07-01,121,0,1,0,0,121,GAB
2017-07-01,171,13,4,11,1898,182,GBR
2017-07-01,1,0,0,0,0,1,GEO
2017-07-01,2,0,11,1,0,3,GHA
2017-07-01,0,0,1,2,0,2,GIN
2017-07-01,0,0,1,9,0,9,GNB
2017-07-01,14,0,0,0,0,14,GNQ
2017-07-01,6,0,0,0,0,6,GRC
2017-07-01,0,0,1,0,0,0,GUF
2017-07-01,16,0,0,3,0,19,HRV
2017-07-01,378,30,49,88,0,466,IDN
2017-07-01,167,1,38,14,0,181,IND
2017-07-01,2,0,2,3,7,5,IRL
2017-07-01,158,3,0,2,0,160,IRN
2017-07-01,1,0,0,8,0,9,IRQ
2017-07-01,0,0,0,2,0,2,ISL
2017-07-01,4,0,1,0,0,4,ISR
2017-07-01,104,8,3,5,0,109,ITA
2017-07-01,0,0,0,2,0,2,JEY
2017-07-01,20,7,38,33,0,53,JPN
2017-07-01,0,0,3,0,0,0,KEN
2017-07-01,3,0,1,7,0,10,KHM
2017-07-01,5,0,57,53,2,58,KOR
2017-07-01,32,2,0,35,0,67,KWT
2017-07-01,0,0,1,0,0,0,LBN
2017-07-01,11,0,2,0,0,11,LBY
2017-07-01,0,0,4,3,0,3,LKA
2017-07-01,1,0,0,0,0,1,LTU
2017-07-01,0,0,1,0,0,0,LVA
2017-07-01,0,0,2,0,0,0,MDG
2017-07-01,189,2,12,0,0,189,MEX
2017-07-01,0,0,1,0,0,0,MLT
2017-07-01,5,1,5,5,0,10,MMR
2017-07-01,0,0,0,3,0,3,MOZ
2017-07-01,1,0,4,0,0,1,MRT
2017-07-01,305,19,67,35,0,340,MYS
2017-07-01,13,0,0,0,0,13,NAM
2017-07-01,371,2,2,1,0,372,NGA
2017-07-01,0,0,2,1,0,1,NIC
2017-07-01,113,12,1,4,294,117,NLD
2017-07-01,17,0,0,9,1,26,NOR
2017-07-01,7,0,3,4,0,11,NZL
2017-07-01,17,0,12,1,0,18,None
2017-07-01,7,0,2,0,0,7,OMN
2017-07-01,0,0,1,0,0,0,PAK
2017-07-01,0,1,2,0,0,0,PAN
2017-07-01,93,1,2,3,0,96,PER
2017-07-01,7,0,6,14,0,21,PHL
2017-07-01,3,0,0,1,0,4,PNG
2017-07-01,9,3,0,5,3,14,POL
2017-07-01,0,0,1,0,0,0,PRI
2017-07-01,1,0,2,5,0,6,PRK
2017-07-01,0,0,1,0,0,0,PRT
2017-07-01,166,0,3,1,0,167,QAT
2017-07-01,7,0,0,0,0,7,ROU
2017-07-01,11,2,5,4,0,15,RUS
2017-07-01,649,27,6,1,0,650,SAU
2017-07-01,1,0,3,0,0,1,SDN
2017-07-01,0,0,0,21,0,21,SGP
2017-07-01,0,0,0,4,0,4,SLE
2017-07-01,0,0,2,1,0,1,SOM
2017-07-01,0,0,1,1,0,1,SUR
2017-07-01,0,0,1,43,73,43,SWE
2017-07-01,2,0,0,0,0,2,TGO
2017-07-01,401,0,12,35,0,436,THA
2017-07-01,319,2,0,1,0,320,TTO
2017-07-01,14,11,2,0,0,14,TUN
2017-07-01,5,0,9,32,0,37,TUR
2017-07-01,7,6,1,0,2,7,TWN
2017-07-01,2,1,0,0,0,2,TZA
2017-07-01,16,3,3,7,0,23,UKR
2017-07-01,0,0,1,0,0,0,URY
2017-07-01,2432,39,2,458,5,2890,USA
2017-07-01,10,2,2,0,0,10,VEN
2017-07-01,44,0,15,108,7,152,VNM
2017-07-01,0,0,1,0,0,0,VUT
2017-07-01,2,0,5,1,0,3,YEM
2017-07-01,1,0,2,1,0,2,ZAF
2017-08-01,3,0,0,0,0,3,ABW
2017-08-01,245,1,0,0,0,245,AGO
2017-08-01,0,1,0,0,0,0,ALB
2017-08-01,537,1,2,9,0,546,ARE
2017-08-01,0,0,1,0,0,0,ASM
2017-08-01,0,0,1,0,0,0,ATG
2017-08-01,64,2,23,33,0,97,AUS
2017-08-01,0,0,1,5,236,5,BEL
2017-08-01,6,0,0,0,0,6,BEN
2017-08-01,0,0,1,0,0,0,BES
2017-08-01,1,3,0,1,0,2,BGD
2017-08-01,1,0,0,0,0,1,BGR
2017-08-01,3,0,1,1,0,4,BHR
2017-08-01,0,0,3,4,0,4,BHS
2017-08-01,136,13,7,15,0,151,BRA
2017-08-01,119,1,0,0,0,119,BRN
2017-08-01,6,0,9,20,0,26,CAN
2017-08-01,0,0,1,0,0,0,CHL
2017-08-01,273,28,88,153,771,426,CHN
2017-08-01,12,0,0,0,0,12,CIV
2017-08-01,62,0,0,0,0,62,CMR
2017-08-01,50,0,0,0,0,50,COD
2017-08-01,76,0,0,0,0,76,COG
2017-08-01,3,0,1,1,0,4,COL
2017-08-01,2,0,4,2,0,4,CUB
2017-08-01,21,16,2,29,1228,50,DEU
2017-08-01,1,0,1,0,0,1,DJI
2017-08-01,0,0,1,0,0,0,DMA
2017-08-01,17,2,0,16,460,33,DNK
2017-08-01,0,0,1,0,0,0,DOM
2017-08-01,0,0,4,2,0,2,DZA
2017-08-01,5,0,2,0,0,5,ECU
2017-08-01,177,5,0,4,0,181,EGY
2017-08-01,0,0,4,0,0,0,ERI
2017-08-01,3,8,0,6,0,9,ESP
2017-08-01,0,0,0,1,0,1,EST
2017-08-01,0,0,1,51,6,51,FIN
2017-08-01,0,0,1,24,0,24,FRA
2017-08-01,121,0,1,0,0,121,GAB
2017-08-01,170,11,4,12,1929,182,GBR
2017-08-01,1,0,0,0,0,1,GEO
2017-08-01,2,0,14,1,0,3,GHA
2017-08-01,0,0,1,2,0,2,GIN
2017-08-01,0,0,1,0,0,0,GMB
2017-08-01,0,0,1,9,0,9,GNB
2017-08-01,14,0,0,0,0,14,GNQ
2017-08-01,6,1,0,0,0,6,GRC
2017-08-01,0,0,1,0,0,0,GRD
2017-08-01,0,0,1,0,0,0,GUF
2017-08-01,16,0,0,3,0,19,HRV
2017-08-01,379,38,56,104,0,483,IDN
2017-08-01,170,1,39,14,0,184,IND
2017-08-01,2,0,2,4,7,6,IRL
2017-08-01,159,3,0,2,0,161,IRN
2017-08-01,1,0,0,8,0,9,IRQ
2017-08-01,0,0,0,2,0,2,ISL
2017-08-01,4,0,1,0,0,4,ISR
2017-08-01,104,9,3,6,0,110,ITA
2017-08-01,0,0,0,2,0,2,JEY
2017-08-01,20,7,38,34,0,54,JPN
2017-08-01,0,0,3,0,0,0,KEN
2017-08-01,3,0,1,7,0,10,KHM
2017-08-01,6,0,56,52,3,58,KOR
2017-08-01,32,1,0,26,0,58,KWT
2017-08-01,0,0,1,1,0,1,LBN
2017-08-01,12,0,2,0,0,12,LBY
2017-08-01,0,0,4,3,0,3,LKA
2017-08-01,1,0,0,0,0,1,LTU
2017-08-01,0,0,1,0,0,0,LVA
2017-08-01,0,0,1,0,0,0,MDG
2017-08-01,193,2,12,0,0,193,MEX
2017-08-01,0,0,1,0,0,0,MLT
2017-08-01,4,1,5,5,0,9,MMR
2017-08-01,0,0,0,3,0,3,MOZ
2017-08-01,1,0,4,0,0,1,MRT
2017-08-01,305,22,66,38,0,343,MYS
2017-08-01,13,0,0,0,0,13,NAM
2017-08-01,371,2,2,1,0,372,NGA
2017-08-01,0,0,2,1,0,1,NIC
2017-08-01,111,12,1,4,294,115,NLD
2017-08-01,14,0,0,8,1,22,NOR
2017-08-01,7,0,3,4,0,11,NZL
2017-08-01,17,0,11,1,0,18,None
2017-08-01,7,0,2,0,0,7,OMN
2017-08-01,0,0,1,0,0,0,PAK
2017-08-01,0,1,1,0,0,0,PAN
2017-08-01,88,1,2,1,0,89,PER
2017-08-01,7,0,7,13,0,20,PHL
2017-08-01,3,0,1,2,0,5,PNG
2017-08-01,9,3,0,4,3,13,POL
2017-08-01,0,0,1,0,0,0,PRI
2017-08-01,1,0,2,4,0,5,PRK
2017-08-01,0,0,1,0,0,0,PRT
2017-08-01,165,0,3,1,0,166,QAT
2017-08-01,7,1,0,0,0,7,ROU
2017-08-01,10,2,5,5,0,15,RUS
2017-08-01,649,28,6,1,0,650,SAU
2017-08-01,1,0,3,0,0,1,SDN
2017-08-01,0,0,0,25,0,25,SGP
2017-08-01,0,0,0,5,0,5,SLE
2017-08-01,0,0,2,1,0,1,SOM
2017-08-01,0,0,1,1,0,1,SUR
2017-08-01,0,0,1,43,73,43,SWE
2017-08-01,3,0,0,0,0,3,TGO
2017-08-01,403,0,14,43,0,446,THA
2017-08-01,320,3,0,1,0,321,TTO
2017-08-01,13,11,2,0,0,13,TUN
2017-08-01,5,1,9,32,0,37,TUR
2017-08-01,7,6,1,0,2,7,TWN
2017-08-01,2,0,0,0,0,2,TZA
2017-08-01,17,4,3,7,0,24,UKR
2017-08-01,0,0,1,0,0,0,URY
2017-08-01,2428,40,1,454,5,2882,USA
2017-08-01,10,2,3,2,0,12,VEN
2017-08-01,43,0,15,112,8,155,VNM
2017-08-01,0,0,1,0,0,0,VUT
2017-08-01,2,0,5,1,0,3,YEM
2017-08-01,1,0,2,1,0,2,ZAF
2017-09-01,3,0,0,0,0,3,ABW
2017-09-01,249,1,0,0,0,249,AGO
2017-09-01,0,2,0,0,0,0,ALB
2017-09-01,544,1,2,8,0,552,ARE
2017-09-01,0,0,1,0,0,0,ASM
2017-09-01,0,0,1,0,0,0,ATG
2017-09-01,63,2,22,34,0,97,AUS
2017-09-01,0,1,1,5,255,5,BEL
2017-09-01,7,0,0,0,0,7,BEN
2017-09-01,0,0,1,0,0,0,BES
2017-09-01,1,3,0,1,0,2,BGD
2017-09-01,1,0,0,0,0,1,BGR
2017-09-01,3,0,1,1,0,4,BHR
2017-09-01,0,0,3,3,0,3,BHS
2017-09-01,130,12,6,16,0,146,BRA
2017-09-01,120,1,0,0,0,120,BRN
2017-09-01,6,0,9,19,0,25,CAN
2017-09-01,0,0,1,0,0,0,CHL
2017-09-01,268,32,85,166,810,434,CHN
2017-09-01,12,0,0,0,0,12,CIV
2017-09-01,70,0,0,0,0,70,CMR
2017-09-01,50,0,0,0,0,50,COD
2017-09-01,78,0,0,0,0,78,COG
2017-09-01,3,0,0,1,0,4,COL
2017-09-01,2,0,5,2,0,4,CUB
2017-09-01,21,16,2,29,1231,50,DEU
2017-09-01,1,0,1,0,0,1,DJI
2017-09-01,0,0,1,0,0,0,DMA
2017-09-01,16,2,0,17,460,33,DNK
2017-09-01,0,0,1,0,0,0,DOM
2017-09-01,0,0,4,1,0,1,DZA
2017-09-01,5,0,2,0,0,5,ECU
2017-09-01,175,5,0,5,0,180,EGY
2017-09-01,0,0,5,0,0,0,ERI
2017-09-01,3,8,0,6,0,9,ESP
2017-09-01,0,0,0,1,0,1,EST
2017-09-01,0,0,1,52,6,52,FIN
2017-09-01,0,0,1,22,0,22,FRA
2017-09-01,118,0,1,0,0,118,GAB
2017-09-01,166,11,4,14,1958,180,GBR
2017-09-01,1,0,0,0,0,1,GEO
2017-09-01,2,0,16,1,0,3,GHA
2017-09-01,0,0,1,1,0,1,GIN
2017-09-01,0,0,1,0,0,0,GMB
2017-09-01,0,0,1,9,0,9,GNB
2017-09-01,14,0,0,0,0,14,GNQ
2017-09-01,5,1,0,0,0,5,GRC
2017-09-01,0,0,1,0,0,0,GRD
2017-09-01,0,0,1,0,0,0,GUF
2017-09-01,16,0,0,3,0,19,HRV
2017-09-01,509,36,58,101,0,610,IDN
2017-09-01,171,1,38,14,0,185,IND
2017-09-01,2,0,1,4,7,6,IRL
2017-09-01,159,3,0,1,0,160,IRN
2017-09-01,1,0,0,8,0,9,IRQ
2017-09-01,0,0,0,2,0,2,ISL
2017-09-01,4,0,1,0,0,4,ISR
2017-09-01,104,9,3,5,0,109,ITA
2017-09-01,0,0,0,2,0,2,JEY
2017-09-01,20,7,40,31,0,51,JPN
2017-09-01,0,0,3,0,0,0,KEN
2017-09-01,3,0,1,7,0,10,KHM
2017-09-01,6,0,56,45,3,51,KOR
2017-09-01,34,1,0,22,0,56,KWT
2017-09-01,0,0,1,1,0,1,LBN
2017-09-01,12,0,2,0,0,12,LBY
2017-09-01,0,0,4,3,0,3,LKA
2017-09-01,1,0,0,0,0,1,LTU
2017-09-01,0,0,1,0,0,0,LVA
2017-09-01,0,0,1,0,0,0,MDG
2017-09-01,195,2,12,0,0,195,MEX
2017-09-01,4,2,6,7,0,11,MMR
2017-09-01,0,0,0,3,0,3,MOZ
2017-09-01,1,0,4,0,0,1,MRT
2017-09-01,300,17,74,40,0,340,MYS
2017-09-01,9,0,0,0,0,9,NAM
2017-09-01,378,2,2,0,0,378,NGA
2017-09-01,0,0,2,1,0,1,NIC
2017-09-01,114,11,1,2,293,116,NLD
2017-09-01,15,0,0,8,1,23,NOR
2017-09-01,7,0,3,5,0,12,NZL
2017-09-01,17,0,12,3,0,20,None
2017-09-01,7,0,3,0,0,7,OMN
2017-09-01,0,0,1,0,0,0,PAK
2017-09-01,0,2,1,1,0,1,PAN
2017-09-01,87,1,2,3,0,90,PER
2017-09-01,7,0,7,16,0,23,PHL
2017-09-01,3,0,3,2,0,5,PNG
2017-09-01,9,3,0,4,3,13,POL
2017-09-01,0,0,1,0,0,0,PRI
2017-09-01,1,0,3,3,0,4,PRK
2017-09-01,0,0,1,0,0,0,PRT
2017-09-01,165,0,4,2,0,167,QAT
2017-09-01,8,2,0,0,0,8,ROU
2017-09-01,10,2,5,7,0,17,RUS
2017-09-01,655,29,7,1,0,656,SAU
2017-09-01,1,0,3,0,0,1,SDN
2017-09-01,0,0,0,25,0,25,SGP
2017-09-01,0,0,0,5,0,5,SLE
2017-09-01,0,0,1,1,0,1,SOM
2017-09-01,0,0,1,1,0,1,SUR
2017-09-01,0,0,1,41,73,41,SWE
2017-09-01,3,0,0,0,0,3,TGO
2017-09-01,405,0,13,44,0,449,THA
2017-09-01,323,4,0,1,0,324,TTO
2017-09-01,13,12,2,0,0,13,TUN
2017-09-01,5,1,10,36,0,41,TUR
2017-09-01,8,5,1,0,2,8,TWN
2017-09-01,2,0,0,0,0,2,TZA
2017-09-01,16,4,3,8,0,24,UKR
2017-09-01,0,0,1,0,0,0,URY
2017-09-01,2413,40,1,458,5,2871,USA
2017-09-01,10,3,3,2,0,12,VEN
2017-09-01,42,0,16,108,7,150,VNM
2017-09-01,0,0,1,0,0,0,VUT
2017-09-01,2,0,5,1,0,3,YEM
2017-09-01,1,0,2,1,0,2,ZAF
2017-10-01,4,0,0,0,0,4,ABW
2017-10-01,249,1,0,0,0,249,AGO
2017-10-01,0,2,0,0,0,0,ALB
2017-10-01,545,1,2,9,0,554,ARE
2017-10-01,0,0,1,0,0,0,ASM
2017-10-01,0,0,1,0,0,0,ATG
2017-10-01,65,2,21,35,0,100,AUS
2017-10-01,0,1,1,5,274,5,BEL
2017-10-01,7,0,0,0,0,7,BEN
2017-10-01,0,0,1,0,0,0,BES
2017-10-01,1,3,0,2,0,3,BGD
2017-10-01,1,0,0,0,0,1,BGR
2017-10-01,3,0,1,1,0,4,BHR
2017-10-01,0,0,3,3,0,3,BHS
2017-10-01,135,15,5,15,0,150,BRA
2017-10-01,119,1,0,0,0,119,BRN
2017-10-01,6,0,9,18,0,24,CAN
2017-10-01,0,0,1,0,0,0,CHL
2017-10-01,268,31,84,166,834,434,CHN
2017-10-01,12,0,0,0,0,12,CIV
2017-10-01,70,0,0,0,0,70,CMR
2017-10-01,50,0,0,0,0,50,COD
2017-10-01,78,0,0,0,0,78,COG
2017-10-01,5,0,1,2,0,7,COL
2017-10-01,2,0,5,2,0,4,CUB
2017-10-01,21,16,2,29,1246,50,DEU
2017-10-01,2,0,1,0,0,2,DJI
2017-10-01,0,0,1,0,0,0,DMA
2017-10-01,16,2,0,15,461,31,DNK
2017-10-01,0,0,1,0,0,0,DOM
2017-10-01,0,0,4,1,0,1,DZA
2017-10-01,6,1,2,0,0,6,ECU
2017-10-01,175,8,0,5,0,180,EGY
2017-10-01,0,0,4,0,0,0,ERI
2017-10-01,3,9,0,6,0,9,ESP
2017-10-01,0,0,0,1,0,1,EST
2017-10-01,0,0,1,52,6,52,FIN
2017-10-01,0,0,1,20,0,20,FRA
2017-10-01,118,0,1,0,0,118,GAB
2017-10-01,168,12,6,14,1958,182,GBR
2017-10-01,1,0,0,0,0,1,GEO
2017-10-01,2,0,18,1,0,3,GHA
2017-10-01,0,0,1,1,0,1,GIN
2017-10-01,0,0,1,0,0,0,GMB
2017-10-01,0,0,1,7,0,7,GNB
2017-10-01,13,0,0,0,0,13,GNQ
2017-10-01,5,1,0,0,0,5,GRC
2017-10-01,0,0,1,0,0,0,GUF
2017-10-01,0,0,0,1,0,1,GUY
2017-10-01,16,0,0,3,0,19,HRV
2017-10-01,499,35,51,94,0,593,IDN
2017-10-01,167,1,37,13,0,180,IND
2017-10-01,2,0,1,3,7,5,IRL
2017-10-01,155,1,0,1,0,156,IRN
2017-10-01,1,0,0,7,0,8,IRQ
2017-10-01,0,0,0,2,0,2,ISL
2017-10-01,4,0,1,0,0,4,ISR
2017-10-01,103,7,3,4,0,107,ITA
2017-10-01,0,0,0,2,0,2,JEY
2017-10-01,20,7,39,30,0,50,JPN
2017-10-01,0,0,3,0,0,0,KEN
2017-10-01,3,0,1,7,0,10,KHM
2017-10-01,6,0,54,43,4,49,KOR
2017-10-01,36,1,0,25,0,61,KWT
2017-10-01,0,0,1,1,0,1,LBN
2017-10-01,0,0,1,0,0,0,LBR
2017-10-01,11,0,2,0,0,11,LBY
2017-10-01,0,0,4,3,0,3,LKA
2017-10-01,1,0,0,0,0,1,LTU
2017-10-01,0,0,1,0,0,0,LVA
2017-10-01,0,0,1,0,0,0,MDG
2017-10-01,193,2,12,0,0,193,MEX
2017-10-01,4,2,7,7,0,11,MMR
2017-10-01,0,0,0,3,0,3,MOZ
2017-10-01,1,0,4,0,0,1,MRT
2017-10-01,300,18,74,35,0,335,MYS
2017-10-01,10,0,0,0,0,10,NAM
2017-10-01,402,2,2,0,0,402,NGA
2017-10-01,0,0,2,1,0,1,NIC
2017-10-01,113,11,1,2,294,115,NLD
2017-10-01,15,0,0,6,1,21,NOR
2017-10-01,7,0,3,5,0,12,NZL
2017-10-01,17,0,13,3,0,20,None
2017-10-01,7,0,2,0,0,7,OMN
2017-10-01,0,0,1,0,0,0,PAK
2017-10-01,0,2,3,1,0,1,PAN
2017-10-01,95,1,3,3,0,98,PER
2017-10-01,7,0,7,15,0,22,PHL
2017-10-01,4,0,3,2,0,6,PNG
2017-10-01,9,3,0,4,3,13,POL
2017-10-01,0,0,1,0,0,0,PRI
2017-10-01,1,0,3,3,0,4,PRK
2017-10-01,0,0,1,0,0,0,PRT
2017-10-01,164,0,4,2,0,166,QAT
2017-10-01,8,2,0,0,0,8,ROU
2017-10-01,9,2,5,8,0,17,RUS
2017-10-01,653,28,6,1,0,654,SAU
2017-10-01,1,0,3,0,0,1,SDN
2017-10-01,1,0,0,0,0,1,SEN
2017-10-01,0,0,0,27,0,27,SGP
2017-10-01,0,0,0,5,0,5,SLE
2017-10-01,0,0,1,1,0,1,SOM
2017-10-01,0,0,2,41,73,41,SWE
2017-10-01,3,0,0,0,0,3,TGO
2017-10-01,405,0,13,89,0,494,THA
2017-10-01,323,4,0,1,0,324,TTO
2017-10-01,13,13,2,0,0,13,TUN
2017-10-01,5,1,11,37,0,42,TUR
2017-10-01,8,5,2,0,2,8,TWN
2017-10-01,2,0,0,0,0,2,TZA
2017-10-01,16,4,3,8,0,24,UKR
2017-10-01,0,0,1,0,0,0,URY
2017-10-01,2386,42,1,449,5,2835,USA
2017-10-01,8,3,3,3,0,11,VEN
2017-10-01,40,0,16,103,6,143,VNM
2017-10-01,0,0,1,0,0,0,VUT
2017-10-01,3,0,6,0,0,3,YEM
2017-10-01,1,0,2,1,0,2,ZAF
2017-11-01,4,0,0,0,0,4,ABW
2017-11-01,250,1,0,0,0,250,AGO
2017-11-01,0,1,0,0,0,0,ALB
2017-11-01,543,1,2,8,0,551,ARE
2017-11-01,0,0,1,0,0,0,ASM
2017-11-01,0,0,1,0,0,0,ATG
2017-11-01,66,2,21,37,0,103,AUS
2017-11-01,0,0,1,5,278,5,BEL
2017-11-01,6,0,0,0,0,6,BEN
2017-11-01,0,0,1,0,0,0,BES
2017-11-01,1,3,0,2,0,3,BGD
2017-11-01,1,0,0,0,0,1,BGR
2017-11-01,3,0,2,0,0,3,BHR
2017-11-01,0,0,3,3,0,3,BHS
2017-11-01,137,13,5,11,0,148,BRA
2017-11-01,120,1,0,0,0,120,BRN
2017-11-01,6,0,8,19,0,25,CAN
2017-11-01,0,0,1,0,0,0,CHL
2017-11-01,269,31,77,172,873,441,CHN
2017-11-01,12,0,1,0,0,12,CIV
2017-11-01,70,0,0,0,0,70,CMR
2017-11-01,50,0,0,0,0,50,COD
2017-11-01,76,0,0,0,0,76,COG
2017-11-01,6,0,1,2,0,8,COL
2017-11-01,2,0,5,2,0,4,CUB
2017-11-01,21,16,2,29,1283,50,DEU
2017-11-01,2,0,1,0,0,2,DJI
2017-11-01,0,0,1,0,0,0,DMA
2017-11-01,18,2,0,15,464,33,DNK
2017-11-01,0,0,1,0,0,0,DOM
2017-11-01,0,0,4,1,0,1,DZA
2017-11-01,11,1,2,0,0,11,ECU
2017-11-01,177,8,0,5,0,182,EGY
2017-11-01,0,0,4,0,0,0,ERI
2017-11-01,2,8,0,7,0,9,ESP
2017-11-01,0,0,0,1,0,1,EST
2017-11-01,0,0,1,51,6,51,FIN
2017-11-01,0,0,1,25,0,25,FRA
2017-11-01,118,0,1,0,0,118,GAB
2017-11-01,174,12,6,14,1957,188,GBR
2017-11-01,1,0,0,0,0,1,GEO
2017-11-01,2,0,17,1,0,3,GHA
2017-11-01,0,0,1,2,0,2,GIN
2017-11-01,0,0,1,0,0,0,GMB
2017-11-01,0,0,1,6,0,6,GNB
2017-11-01,13,0,0,0,0,13,GNQ
2017-11-01,5,1,0,0,0,5,GRC
2017-11-01,0,0,1,0,0,0,GUF
2017-11-01,0,0,0,1,0,1,GUY
2017-11-01,16,0,0,3,0,19,HRV
2017-11-01,503,33,43,97,0,600,IDN
2017-11-01,163,1,30,10,0,173,IND
2017-11-01,3,0,1,3,7,6,IRL
2017-11-01,160,1,0,1,0,161,IRN
2017-11-01,1,0,0,8,0,9,IRQ
2017-11-01,0,0,0,2,0,2,ISL
2017-11-01,4,0,1,0,0,4,ISR
2017-11-01,102,7,3,4,0,106,ITA
2017-11-01,0,0,0,2,0,2,JEY
2017-11-01,18,11,36,33,0,51,JPN
2017-11-01,0,0,3,0,0,0,KEN
2017-11-01,3,0,1,6,0,9,KHM
2017-11-01,5,0,52,46,4,51,KOR
2017-11-01,37,1,0,23,0,60,KWT
2017-11-01,0,0,1,0,0,0,LBN
2017-11-01,0,0,2,0,0,0,LBR
2017-11-01,11,0,1,1,0,12,LBY
2017-11-01,0,0,4,3,0,3,LKA
2017-11-01,1,0,0,0,0,1,LTU
2017-11-01,0,0,1,0,0,0,LVA
2017-11-01,0,0,1,0,0,0,MDG
2017-11-01,192,1,12,0,0,192,MEX
2017-11-01,4,2,8,7,0,11,MMR
2017-11-01,0,0,0,2,0,2,MOZ
2017-11-01,1,0,4,0,0,1,MRT
2017-11-01,300,20,69,34,0,334,MYS
2017-11-01,8,0,0,0,0,8,NAM
2017-11-01,417,2,4,0,0,417,NGA
2017-11-01,0,0,2,1,0,1,NIC
2017-11-01,112,11,1,2,295,114,NLD
2017-11-01,13,0,0,6,1,19,NOR
2017-11-01,7,0,3,5,0,12,NZL
2017-11-01,16,0,11,3,0,19,None
2017-11-01,7,0,2,0,0,7,OMN
2017-11-01,0,0,1,0,0,0,PAK
2017-11-01,0,2,3,1,0,1,PAN
2017-11-01,96,1,4,4,0,100,PER
2017-11-01,7,0,7,15,0,22,PHL
2017-11-01,4,0,2,2,0,6,PNG
2017-11-01,9,3,0,6,3,15,POL
2017-11-01,0,0,1,0,0,0,PRI
2017-11-01,1,0,3,4,0,5,PRK
2017-11-01,0,0,1,0,0,0,PRT
2017-11-01,163,0,4,2,0,165,QAT
2017-11-01,7,1,0,0,0,7,ROU
2017-11-01,8,2,4,4,0,12,RUS
2017-11-01,659,28,6,1,0,660,SAU
2017-11-01,1,0,3,0,0,1,SDN
2017-11-01,3,0,0,0,0,3,SEN
2017-11-01,0,0,0,27,0,27,SGP
2017-11-01,0,0,0,5,0,5,SLE
2017-11-01,0,0,1,2,0,2,SOM
2017-11-01,0,0,2,41,72,41,SWE
2017-11-01,2,0,0,0,0,2,TGO
2017-11-01,404,0,13,104,0,508,THA
2017-11-01,317,3,0,1,0,318,TTO
2017-11-01,13,13,2,0,0,13,TUN
2017-11-01,5,1,11,39,0,44,TUR
2017-11-01,8,5,2,0,2,8,TWN
2017-11-01,2,0,0,0,0,2,TZA
2017-11-01,15,4,3,8,0,23,UKR
2017-11-01,0,0,1,0,0,0,URY
2017-11-01,2357,44,1,435,5,2792,USA
2017-11-01,8,4,3,2,0,10,VEN
2017-11-01,1,0,0,0,0,1,VIR
2017-11-01,42,0,17,99,7,141,VNM
2017-11-01,0,0,1,0,0,0,VUT
2017-11-01,4,0,8,0,0,4,YEM
2017-11-01,1,0,2,1,0,2,ZAF
2017-12-01,2,0,0,0,0,2,ABW
2017-12-01,251,1,0,0,0,251,AGO
2017-12-01,545,1,2,8,0,553,ARE
2017-12-01,0,0,1,0,0,0,ASM
2017-12-01,0,0,1,0,0,0,ATG
2017-12-01,65,2,24,38,0,103,AUS
2017-12-01,0,0,1,5,278,5,BEL
2017-12-01,6,0,0,0,0,6,BEN
2017-12-01,0,0,1,0,0,0,BES
2017-12-01,1,2,0,3,0,4,BGD
2017-12-01,1,0,0,0,0,1,BGR
2017-12-01,3,0,2,0,0,3,BHR
2017-12-01,0,0,3,3,0,3,BHS
2017-12-01,139,12,4,10,0,149,BRA
2017-12-01,119,1,0,0,0,119,BRN
2017-12-01,6,0,7,16,0,22,CAN
2017-12-01,0,0,1,0,0,0,CHL
2017-12-01,273,27,79,185,894,458,CHN
2017-12-01,12,0,1,0,0,12,CIV
2017-12-01,73,1,0,0,0,73,CMR
2017-12-01,50,0,0,0,0,50,COD
2017-12-01,77,0,0,0,0,77,COG
2017-12-01,6,0,1,1,0,7,COL
2017-12-01,2,0,5,2,0,4,CUB
2017-12-01,21,17,2,30,1290,51,DEU
2017-12-01,2,0,1,0,0,2,DJI
2017-12-01,0,0,1,0,0,0,DMA
2017-12-01,16,2,0,16,495,32,DNK
2017-12-01,0,0,1,0,0,0,DOM
2017-12-01,0,0,4,1,0,1,DZA
2017-12-01,11,1,2,0,0,11,ECU
2017-12-01,178,5,0,5,0,183,EGY
2017-12-01,0,0,3,0,0,0,ERI
2017-12-01,2,7,0,7,0,9,ESP
2017-12-01,0,0,0,1,0,1,EST
2017-12-01,0,0,1,47,6,47,FIN
2017-12-01,0,0,1,22,0,22,FRA
2017-12-01,120,0,1,0,0,120,GAB
2017-12-01,170,11,5,11,1958,181,GBR
2017-12-01,1,0,0,0,0,1,GEO
2017-12-01,2,0,12,1,0,3,GHA
2017-12-01,0,0,1,2,0,2,GIN
2017-12-01,0,0,1,0,0,0,GMB
2017-12-01,0,0,1,5,0,5,GNB
2017-12-01,13,0,0,0,0,13,GNQ
2017-12-01,4,0,0,0,0,4,GRC
2017-12-01,0,0,1,0,0,0,GUF
2017-12-01,0,0,0,1,0,1,GUY
2017-12-01,16,0,0,3,0,19,HRV
2017-12-01,539,37,46,99,0,638,IDN
2017-12-01,168,1,37,17,0,185,IND
2017-12-01,3,0,1,3,7,6,IRL
2017-12-01,161,1,0,1,0,162,IRN
2017-12-01,1,0,0,10,0,11,IRQ
2017-12-01,0,0,0,1,0,1,ISL
2017-12-01,5,0,1,0,0,5,ISR
2017-12-01,103,6,3,4,0,107,ITA
2017-12-01,0,0,0,1,0,1,JEY
2017-12-01,18,11,36,36,0,54,JPN
2017-12-01,0,0,3,0,0,0,KEN
2017-12-01,3,0,1,5,0,8,KHM
2017-12-01,5,0,51,46,4,51,KOR
2017-12-01,36,1,0,24,0,60,KWT
2017-12-01,0,0,1,0,0,0,LBN
2017-12-01,0,0,2,3,0,3,LBR
2017-12-01,11,0,1,1,0,12,LBY
2017-12-01,0,0,4,3,0,3,LKA
2017-12-01,1,0,0,0,0,1,LTU
2017-12-01,0,0,1,0,0,0,LVA
2017-12-01,0,0,1,0,0,0,MDG
2017-12-01,193,1,13,0,0,193,MEX
2017-12-01,4,2,11,8,0,12,MMR
2017-12-01,0,0,0,2,0,2,MOZ
2017-12-01,1,0,4,0,0,1,MRT
2017-12-01,319,18,60,32,0,351,MYS
2017-12-01,7,0,0,0,0,7,NAM
2017-12-01,419,2,4,0,0,419,NGA
2017-12-01,0,0,2,1,0,1,NIC
2017-12-01,115,10,1,2,295,117,NLD
2017-12-01,13,0,0,7,1,20,NOR
2017-12-01,7,0,4,6,0,13,NZL
2017-12-01,16,0,10,2,0,18,None
2017-12-01,7,0,2,1,0,8,OMN
2017-12-01,0,0,1,0,0,0,PAK
2017-12-01,0,2,3,1,0,1,PAN
2017-12-01,95,1,4,6,0,101,PER
2017-12-01,7,0,7,11,0,18,PHL
2017-12-01,4,0,2,2,0,6,PNG
2017-12-01,9,3,0,6,3,15,POL
2017-12-01,0,0,1,0,0,0,PRI
2017-12-01,1,0,3,4,0,5,PRK
2017-12-01,0,0,1,0,0,0,PRT
2017-12-01,162,0,5,2,0,164,QAT
2017-12-01,7,1,0,0,0,7,ROU
2017-12-01,9,2,4,4,0,13,RUS
2017-12-01,661,26,6,2,0,663,SAU
2017-12-01,1,0,3,0,0,1,SDN
2017-12-01,3,0,0,0,0,3,SEN
2017-12-01,0,0,0,24,0,24,SGP
2017-12-01,0,0,0,1,0,1,SLB
2017-12-01,0,0,0,4,0,4,SLE
2017-12-01,0,0,1,2,0,2,SOM
2017-12-01,0,0,1,40,72,40,SWE
2017-12-01,2,0,0,0,0,2,TGO
2017-12-01,405,0,14,114,0,519,THA
2017-12-01,313,3,0,1,0,314,TTO
2017-12-01,14,12,2,0,0,14,TUN
2017-12-01,5,1,11,40,0,45,TUR
2017-12-01,8,5,2,0,2,8,TWN
2017-12-01,2,0,0,0,0,2,TZA
2017-12-01,15,4,2,8,0,23,UKR
2017-12-01,0,0,1,0,0,0,URY
2017-12-01,2343,45,1,440,5,2783,USA
2017-12-01,9,4,3,2,0,11,VEN
2017-12-01,1,0,0,0,0,1,VIR
2017-12-01,42,0,17,103,8,145,VNM
2017-12-01,0,0,1,0,0,0,VUT
2017-12-01,3,0,10,1,0,4,YEM
2017-12-01,1,0,2,1,0,2,ZAF
2018-01-01,2,0,0,0,0,2,ABW
2018-01-01,251,1,0,0,0,251,AGO
2018-01-01,545,1,2,9,0,554,ARE
2018-01-01,0,0,1,0,0,0,ASM
2018-01-01,0,0,1,0,0,0,ATG
2018-01-01,63,2,26,32,0,95,AUS
2018-01-01,0,0,1,5,278,5,BEL
2018-01-01,6,0,0,0,0,6,BEN
2018-01-01,0,0,1,0,0,0,BES
2018-01-01,2,2,0,2,0,4,BGD
2018-01-01,1,0,0,0,0,1,BGR
2018-01-01,3,0,2,1,0,4,BHR
2018-01-01,0,0,4,3,0,3,BHS
2018-01-01,143,11,4,7,0,150,BRA
2018-01-01,121,1,0,0,0,121,BRN
2018-01-01,6,0,6,13,0,19,CAN
2018-01-01,0,0,1,0,0,0,CHL
2018-01-01,281,34,81,191,925,472,CHN
2018-01-01,11,0,1,0,0,11,CIV
2018-01-01,73,1,0,0,0,73,CMR
2018-01-01,49,0,0,0,0,49,COD
2018-01-01,75,0,0,0,0,75,COG
2018-01-01,5,0,1,1,0,6,COL
2018-01-01,3,0,5,2,0,5,CUB
2018-01-01,21,17,2,30,1290,51,DEU
2018-01-01,2,0,1,0,0,2,DJI
2018-01-01,0,0,1,0,0,0,DMA
2018-01-01,17,2,0,17,510,34,DNK
2018-01-01,0,0,1,0,0,0,DOM
2018-01-01,0,0,4,1,0,1,DZA
2018-01-01,11,1,2,0,0,11,ECU
2018-01-01,179,5,0,5,0,184,EGY
2018-01-01,0,0,3,0,0,0,ERI
2018-01-01,2,7,0,6,0,8,ESP
2018-01-01,0,0,0,1,0,1,EST
2018-01-01,0,0,0,43,6,43,FIN
2018-01-01,0,0,1,22,0,22,FRA
2018-01-01,120,0,1,0,0,120,GAB
2018-01-01,170,10,4,12,1959,182,GBR
2018-01-01,1,0,0,0,0,1,GEO
2018-01-01,2,0,10,1,0,3,GHA
2018-01-01,0,0,1,2,0,2,GIN
2018-01-01,0,0,1,0,0,0,GMB
2018-01-01,0,0,2,4,0,4,GNB
2018-01-01,13,0,0,0,0,13,GNQ
2018-01-01,4,0,0,0,0,4,GRC
2018-01-01,0,0,1,0,0,0,GUF
2018-01-01,16,0,0,3,0,19,HRV
2018-01-01,537,44,46,96,0,633,IDN
2018-01-01,171,1,42,17,0,188,IND
2018-01-01,2,0,1,3,7,5,IRL
2018-01-01,163,2,0,1,0,164,IRN
2018-01-01,1,0,0,11,0,12,IRQ
2018-01-01,0,0,0,1,0,1,ISL
2018-01-01,5,0,1,0,0,5,ISR
2018-01-01,102,5,4,4,0,106,ITA
2018-01-01,0,0,0,1,0,1,JEY
2018-01-01,19,10,36,33,0,52,JPN
2018-01-01,0,0,3,0,0,0,KEN
2018-01-01,3,0,1,4,0,7,KHM
2018-01-01,5,0,47,50,4,55,KOR
2018-01-01,34,1,0,20,0,54,KWT
2018-01-01,0,0,1,0,0,0,LBN
2018-01-01,0,0,3,3,0,3,LBR
2018-01-01,12,0,1,0,0,12,LBY
2018-01-01,0,0,4,3,0,3,LKA
2018-01-01,1,0,0,0,0,1,LTU
2018-01-01,0,0,1,0,0,0,LVA
2018-01-01,0,0,1,0,0,0,MDG
2018-01-01,192,1,13,0,0,192,MEX
2018-01-01,5,4,11,7,0,12,MMR
2018-01-01,0,0,0,2,0,2,MOZ
2018-01-01,1,0,3,0,0,1,MRT
2018-01-01,322,17,60,31,0,353,MYS
2018-01-01,8,0,0,0,0,8,NAM
2018-01-01,425,2,4,0,0,425,NGA
2018-01-01,0,0,2,1,0,1,NIC
2018-01-01,114,10,1,2,295,116,NLD
2018-01-01,14,0,0,7,1,21,NOR
2018-01-01,7,0,4,6,0,13,NZL
2018-01-01,18,0,11,2,0,20,None
2018-01-01,6,0,2,1,0,7,OMN
2018-01-01,0,0,1,0,0,0,PAK
2018-01-01,0,1,3,2,0,2,PAN
2018-01-01,96,1,4,5,0,101,PER
2018-01-01,7,0,7,12,0,19,PHL
2018-01-01,4,0,2,1,0,5,PNG
2018-01-01,9,3,0,6,3,15,POL
2018-01-01,0,0,1,0,0,0,PRI
2018-01-01,1,0,3,3,0,4,PRK
2018-01-01,0,0,1,0,0,0,PRT
2018-01-01,162,0,5,3,0,165,QAT
2018-01-01,8,1,0,0,0,8,ROU
2018-01-01,11,1,5,4,0,15,RUS
2018-01-01,665,27,7,2,0,667,SAU
2018-01-01,1,0,3,0,0,1,SDN
2018-01-01,2,0,0,0,0,2,SEN
2018-01-01,0,0,0,30,0,30,SGP
2018-01-01,0,0,0,1,0,1,SLB
2018-01-01,0,0,0,4,0,4,SLE
2018-01-01,1,0,1,2,0,3,SOM
2018-01-01,0,0,1,40,72,40,SWE
2018-01-01,3,0,0,0,0,3,TGO
2018-01-01,405,0,15,111,0,516,THA
2018-01-01,321,5,0,1,0,322,TTO
2018-01-01,14,12,1,0,0,14,TUN
2018-01-01,5,1,11,41,0,46,TUR
2018-01-01,7,5,2,0,2,7,TWN
2018-01-01,2,0,0,0,0,2,TZA
2018-01-01,15,4,2,8,0,23,UKR
2018-01-01,0,0,1,0,0,0,URY
2018-01-01,2347,47,2,456,5,2803,USA
2018-01-01,10,3,2,1,0,11,VEN
2018-01-01,1,0,0,0,0,1,VIR
2018-01-01,42,0,19,102,8,144,VNM
2018-01-01,0,0,1,0,0,0,VUT
2018-01-01,3,0,10,1,0,4,YEM
2018-01-01,1,0,2,1,0,2,ZAF
2018-02-01,2,0,0,0,0,2,ABW
2018-02-01,249,1,0,0,0,249,AGO
2018-02-01,537,1,2,9,0,546,ARE
2018-02-01,0,0,1,0,0,0,ASM
2018-02-01,0,0,1,0,0,0,ATG
2018-02-01,62,2,24,34,0,96,AUS
2018-02-01,0,0,1,5,278,5,BEL
2018-02-01,6,0,0,0,0,6,BEN
2018-02-01,0,0,1,0,0,0,BES
2018-02-01,2,2,0,2,0,4,BGD
2018-02-01,1,0,0,0,0,1,BGR
2018-02-01,4,0,2,1,0,5,BHR
2018-02-01,0,0,5,3,0,3,BHS
2018-02-01,142,11,4,8,0,150,BRA
2018-02-01,120,1,0,0,0,120,BRN
2018-02-01,6,0,6,10,0,16,CAN
2018-02-01,0,0,1,0,0,0,CHL
2018-02-01,285,35,85,182,933,467,CHN
2018-02-01,11,0,1,0,0,11,CIV
2018-02-01,73,1,0,0,0,73,CMR
2018-02-01,50,0,0,0,0,50,COD
2018-02-01,77,0,0,0,0,77,COG
2018-02-01,5,0,1,2,0,7,COL
2018-02-01,3,0,6,3,0,6,CUB
2018-02-01,21,18,2,29,1292,50,DEU
2018-02-01,1,0,1,0,0,1,DJI
2018-02-01,0,0,1,0,0,0,DMA
2018-02-01,17,2,0,16,510,33,DNK
2018-02-01,0,0,1,0,0,0,DOM
2018-02-01,0,0,4,1,0,1,DZA
2018-02-01,11,1,2,1,0,12,ECU
2018-02-01,176,6,0,5,0,181,EGY
2018-02-01,0,0,3,0,0,0,ERI
2018-02-01,2,8,0,5,0,7,ESP
2018-02-01,0,0,0,1,0,1,EST
2018-02-01,0,0,0,42,7,42,FIN
2018-02-01,0,0,3,22,0,22,FRA
2018-02-01,122,0,1,0,0,122,GAB
2018-02-01,170,8,4,14,1978,184,GBR
2018-02-01,1,0,0,0,0,1,GEO
2018-02-01,2,0,10,1,0,3,GHA
2018-02-01,0,0,1,2,0,2,GIN
2018-02-01,0,0,1,0,0,0,GMB
2018-02-01,0,0,2,7,0,7,GNB
2018-02-01,13,0,0,0,0,13,GNQ
2018-02-01,4,0,0,0,0,4,GRC
2018-02-01,0,0,1,0,0,0,GUF
2018-02-01,16,0,0,3,0,19,HRV
2018-02-01,537,52,48,99,0,636,IDN
2018-02-01,172,0,42,17,0,189,IND
2018-02-01,2,0,1,4,7,6,IRL
2018-02-01,163,2,0,1,0,164,IRN
2018-02-01,1,0,0,7,0,8,IRQ
2018-02-01,0,0,0,1,0,1,ISL
2018-02-01,5,0,1,0,0,5,ISR
2018-02-01,102,5,4,4,0,106,ITA
2018-02-01,0,0,0,1,0,1,JEY
2018-02-01,19,8,37,30,0,49,JPN
2018-02-01,0,0,3,0,0,0,KEN
2018-02-01,3,0,2,5,0,8,KHM
2018-02-01,5,0,51,46,4,51,KOR
2018-02-01,33,1,0,19,0,52,KWT
2018-02-01,0,0,1,0,0,0,LBN
2018-02-01,0,0,2,2,0,2,LBR
2018-02-01,12,0,1,0,0,12,LBY
2018-02-01,0,0,4,3,0,3,LKA
2018-02-01,1,0,0,0,0,1,LTU
2018-02-01,0,0,1,0,0,0,LVA
2018-02-01,0,0,1,0,0,0,MDG
2018-02-01,193,1,13,0,0,193,MEX
2018-02-01,5,4,10,7,0,12,MMR
2018-02-01,0,0,0,2,0,2,MOZ
2018-02-01,1,0,3,0,0,1,MRT
2018-02-01,321,20,62,37,0,358,MYS
2018-02-01,10,0,0,0,0,10,NAM
2018-02-01,427,2,4,1,0,428,NGA
2018-02-01,0,0,2,1,0,1,NIC
2018-02-01,114,12,1,2,294,116,NLD
2018-02-01,13,0,0,7,1,20,NOR
2018-02-01,7,0,3,6,0,13,NZL
2018-02-01,18,0,11,2,0,20,None
2018-02-01,6,0,2,0,0,6,OMN
2018-02-01,0,0,1,0,0,0,PAK
2018-02-01,1,0,4,2,0,3,PAN
2018-02-01,96,1,4,6,0,102,PER
2018-02-01,7,0,8,10,0,17,PHL
2018-02-01,4,0,2,2,0,6,PNG
2018-02-01,9,3,0,5,3,14,POL
2018-02-01,1,0,3,3,0,4,PRK
2018-02-01,0,0,1,0,0,0,PRT
2018-02-01,161,0,5,3,0,164,QAT
2018-02-01,8,1,0,0,0,8,ROU
2018-02-01,11,1,5,4,0,15,RUS
2018-02-01,670,24,7,2,0,672,SAU
2018-02-01,1,0,3,0,0,1,SDN
2018-02-01,4,0,0,0,0,4,SEN
2018-02-01,0,0,0,37,0,37,SGP
2018-02-01,0,0,0,1,0,1,SLB
2018-02-01,0,0,0,3,0,3,SLE
2018-02-01,1,0,1,2,0,3,SOM
2018-02-01,0,0,1,41,72,41,SWE
2018-02-01,3,0,0,0,0,3,TGO
2018-02-01,406,0,15,104,0,510,THA
2018-02-01,330,5,0,1,0,331,TTO
2018-02-01,14,12,1,0,0,14,TUN
2018-02-01,5,0,10,40,0,45,TUR
2018-02-01,7,5,2,0,2,7,TWN
2018-02-01,2,1,0,0,0,2,TZA
2018-02-01,15,4,3,8,0,23,UKR
2018-02-01,0,0,1,0,0,0,URY
2018-02-01,2366,48,2,476,5,2842,USA
2018-02-01,11,3,2,1,0,12,VEN
2018-02-01,1,0,0,0,0,1,VIR
2018-02-01,43,0,21,100,7,143,VNM
2018-02-01,0,0,1,0,0,0,VUT
2018-02-01,3,0,10,1,0,4,YEM
2018-02-01,1,0,2,1,0,2,ZAF
2018-03-01,2,0,0,0,0,2,ABW
2018-03-01,247,1,0,0,0,247,AGO
2018-03-01,536,1,2,10,0,546,ARE
2018-03-01,0,0,1,0,0,0,ASM
2018-03-01,0,0,1,0,0,0,ATG
2018-03-01,60,1,24,36,0,96,AUS
2018-03-01,0,0,1,5,278,5,BEL
2018-03-01,6,0,0,0,0,6,BEN
2018-03-01,0,0,1,0,0,0,BES
2018-03-01,2,2,1,1,0,3,BGD
2018-03-01,1,0,0,0,0,1,BGR
2018-03-01,4,0,2,1,0,5,BHR
2018-03-01,0,0,6,3,0,3,BHS
2018-03-01,0,0,1,0,0,0,BLZ
2018-03-01,143,11,6,8,0,151,BRA
2018-03-01,120,1,0,0,0,120,BRN
2018-03-01,6,0,6,11,0,17,CAN
2018-03-01,0,0,2,0,0,0,CHL
2018-03-01,287,39,88,193,944,480,CHN
2018-03-01,11,0,1,0,0,11,CIV
2018-03-01,72,1,0,0,0,72,CMR
2018-03-01,51,0,0,0,0,51,COD
2018-03-01,79,0,0,0,0,79,COG
2018-03-01,4,0,1,2,0,6,COL
2018-03-01,3,0,6,2,0,5,CUB
2018-03-01,0,0,1,0,0,0,CYP
2018-03-01,22,18,2,29,1294,51,DEU
2018-03-01,1,0,1,0,0,1,DJI
2018-03-01,0,0,1,0,0,0,DMA
2018-03-01,16,2,1,16,511,32,DNK
2018-03-01,0,0,1,0,0,0,DOM
2018-03-01,0,0,4,1,0,1,DZA
2018-03-01,11,1,2,1,0,12,ECU
2018-03-01,174,6,0,7,0,181,EGY
2018-03-01,0,0,4,0,0,0,ERI
2018-03-01,2,8,0,5,0,7,ESP
2018-03-01,0,0,0,1,0,1,EST
2018-03-01,0,0,0,41,7,41,FIN
2018-03-01,0,0,4,23,0,23,FRA
2018-03-01,120,0,1,0,0,120,GAB
2018-03-01,166,9,4,14,2000,180,GBR
2018-03-01,1,0,0,0,0,1,GEO
2018-03-01,2,0,6,1,0,3,GHA
2018-03-01,0,0,2,2,0,2,GIN
2018-03-01,0,0,1,0,0,0,GMB
2018-03-01,0,0,2,9,0,9,GNB
2018-03-01,13,0,0,0,0,13,GNQ
2018-03-01,5,0,0,0,0,5,GRC
2018-03-01,0,0,1,0,0,0,GUF
2018-03-01,16,0,0,3,0,19,HRV
2018-03-01,545,57,49,99,0,644,IDN
2018-03-01,172,0,38,15,0,187,IND
2018-03-01,2,0,1,4,7,6,IRL
2018-03-01,162,3,0,1,0,163,IRN
2018-03-01,1,0,0,6,0,7,IRQ
2018-03-01,0,0,0,1,0,1,ISL
2018-03-01,4,0,1,0,0,4,ISR
2018-03-01,103,5,4,4,0,107,ITA
2018-03-01,0,0,0,2,0,2,JEY
2018-03-01,20,7,36,29,0,49,JPN
2018-03-01,0,0,3,0,0,0,KEN
2018-03-01,3,0,2,5,0,8,KHM
2018-03-01,4,0,54,54,5,58,KOR
2018-03-01,33,1,0,19,0,52,KWT
2018-03-01,0,0,1,0,0,0,LBN
2018-03-01,0,0,2,2,0,2,LBR
2018-03-01,12,0,1,0,0,12,LBY
2018-03-01,0,0,4,3,0,3,LKA
2018-03-01,1,0,0,0,0,1,LTU
2018-03-01,0,0,1,0,0,0,LVA
2018-03-01,0,0,1,0,0,0,MDG
2018-03-01,198,2,13,0,0,198,MEX
2018-03-01,4,4,8,7,0,11,MMR
2018-03-01,0,0,0,3,0,3,MOZ
2018-03-01,1,0,3,0,0,1,MRT
2018-03-01,325,25,61,40,0,365,MYS
2018-03-01,11,0,0,0,0,11,NAM
2018-03-01,431,2,2,1,0,432,NGA
2018-03-01,0,0,2,1,0,1,NIC
2018-03-01,115,12,1,2,293,117,NLD
2018-03-01,11,0,1,6,1,17,NOR
2018-03-01,7,0,2,4,0,11,NZL
2018-03-01,16,0,11,1,0,17,None
2018-03-01,6,0,2,0,0,6,OMN
2018-03-01,0,0,1,0,0,0,PAK
2018-03-01,1,0,4,2,0,3,PAN
2018-03-01,98,1,5,6,0,104,PER
2018-03-01,7,0,8,12,0,19,PHL
2018-03-01,3,0,2,2,0,5,PNG
2018-03-01,9,3,0,5,3,14,POL
2018-03-01,1,0,4,3,0,4,PRK
2018-03-01,0,0,1,0,0,0,PRT
2018-03-01,162,0,5,3,0,165,QAT
2018-03-01,8,1,0,0,0,8,ROU
2018-03-01,11,1,5,4,0,15,RUS
2018-03-01,673,23,7,2,0,675,SAU
2018-03-01,1,0,3,0,0,1,SDN
2018-03-01,4,0,0,0,0,4,SEN
2018-03-01,0,0,0,39,0,39,SGP
2018-03-01,0,0,0,1,0,1,SLB
2018-03-01,0,0,0,3,0,3,SLE
2018-03-01,1,0,1,2,0,3,SOM
2018-03-01,0,1,0,0,0,0,SUR
2018-03-01,0,0,1,42,72,42,SWE
2018-03-01,3,0,0,0,0,3,TGO
2018-03-01,406,0,15,112,0,518,THA
2018-03-01,329,6,0,1,0,330,TTO
2018-03-01,13,13,2,0,0,13,TUN
2018-03-01,5,0,10,38,0,43,TUR
2018-03-01,7,5,2,0,2,7,TWN
2018-03-01,2,1,0,0,0,2,TZA
2018-03-01,15,4,3,8,0,23,UKR
2018-03-01,0,0,1,0,0,0,URY
2018-03-01,2379,45,2,491,5,2870,USA
2018-03-01,10,3,2,1,0,11,VEN
2018-03-01,1,0,0,0,0,1,VIR
2018-03-01,42,0,21,100,10,142,VNM
2018-03-01,0,0,1,0,0,0,VUT
2018-03-01,3,0,10,2,0,5,YEM
2018-03-01,1,0,3,1,0,2,ZAF
2018-04-01,2,0,0,0,0,2,ABW
2018-04-01,244,1,0,0,0,244,AGO
2018-04-01,538,1,2,10,0,548,ARE
2018-04-01,0,0,1,0,0,0,ASM
2018-04-01,0,0,1,0,0,0,ATG
2018-04-01,59,1,26,39,0,98,AUS
2018-04-01,0,0,1,5,278,5,BEL
2018-04-01,6,0,0,0,0,6,BEN
2018-04-01,0,0,1,0,0,0,BES
2018-04-01,3,2,1,1,0,4,BGD
2018-04-01,1,0,0,0,0,1,BGR
2018-04-01,5,0,2,1,0,6,BHR
2018-04-01,0,0,6,4,0,4,BHS
2018-04-01,0,0,1,0,0,0,BLZ
2018-04-01,147,11,6,7,0,154,BRA
2018-04-01,121,1,0,0,0,121,BRN
2018-04-01,6,0,6,20,0,26,CAN
2018-04-01,0,0,2,0,0,0,CHL
2018-04-01,290,42,96,203,963,493,CHN
2018-04-01,11,0,1,0,0,11,CIV
2018-04-01,73,1,0,0,0,73,CMR
2018-04-01,51,0,0,0,0,51,COD
2018-04-01,81,0,0,0,0,81,COG
2018-04-01,4,0,1,1,0,5,COL
2018-04-01,0,0,0,1,0,1,CRI
2018-04-01,3,0,5,1,0,4,CUB
2018-04-01,0,0,1,0,0,0,CYP
2018-04-01,21,18,2,30,1299,51,DEU
2018-04-01,1,0,1,0,0,1,DJI
2018-04-01,0,0,1,0,0,0,DMA
2018-04-01,18,2,1,19,512,37,DNK
2018-04-01,0,0,1,0,0,0,DOM
2018-04-01,0,0,4,1,0,1,DZA
2018-04-01,11,1,2,1,0,12,ECU
2018-04-01,175,5,0,7,0,182,EGY
2018-04-01,0,0,5,0,0,0,ERI
2018-04-01,3,8,0,5,0,8,ESP
2018-04-01,0,0,0,1,0,1,EST
2018-04-01,0,0,0,44,7,44,FIN
2018-04-01,0,0,3,23,0,23,FRA
2018-04-01,120,0,1,0,0,120,GAB
2018-04-01,167,10,4,16,2029,183,GBR
2018-04-01,1,0,0,0,0,1,GEO
2018-04-01,3,0,5,1,0,4,GHA
2018-04-01,0,0,2,2,0,2,GIN
2018-04-01,0,0,1,0,0,0,GMB
2018-04-01,0,0,2,10,0,10,GNB
2018-04-01,13,0,0,0,0,13,GNQ
2018-04-01,4,0,0,0,0,4,GRC
2018-04-01,0,0,1,0,0,0,GUF
2018-04-01,16,0,0,3,0,19,HRV
2018-04-01,548,73,53,109,0,657,IDN
2018-04-01,173,1,38,15,0,188,IND
2018-04-01,2,0,1,4,7,6,IRL
2018-04-01,162,3,0,1,0,163,IRN
2018-04-01,1,0,0,6,0,7,IRQ
2018-04-01,0,0,0,1,0,1,ISL
2018-04-01,4,0,1,0,0,4,ISR
2018-04-01,103,5,3,5,0,108,ITA
2018-04-01,0,0,0,2,0,2,JEY
2018-04-01,20,8,37,31,0,51,JPN
2018-04-01,0,0,3,1,0,1,KEN
2018-04-01,3,0,2,4,0,7,KHM
2018-04-01,4,0,55,56,5,60,KOR
2018-04-01,33,1,0,19,0,52,KWT
2018-04-01,0,0,1,0,0,0,LBN
2018-04-01,0,0,2,1,0,1,LBR
2018-04-01,12,0,1,0,0,12,LBY
2018-04-01,0,0,4,3,0,3,LKA
2018-04-01,1,0,0,0,0,1,LTU
2018-04-01,0,0,1,0,0,0,LVA
2018-04-01,0,0,1,0,0,0,MDG
2018-04-01,193,3,12,0,0,193,MEX
2018-04-01,4,4,7,6,0,10,MMR
2018-04-01,0,0,0,3,0,3,MOZ
2018-04-01,1,0,3,0,0,1,MRT
2018-04-01,332,30,63,41,0,373,MYS
2018-04-01,10,0,0,0,0,10,NAM
2018-04-01,435,3,2,1,0,436,NGA
2018-04-01,0,0,2,1,0,1,NIC
2018-04-01,115,11,1,1,293,116,NLD
2018-04-01,11,0,1,8,1,19,NOR
2018-04-01,7,0,2,4,0,11,NZL
2018-04-01,16,0,13,1,0,17,None
2018-04-01,6,0,2,0,0,6,OMN
2018-04-01,0,0,1,0,0,0,PAK
2018-04-01,1,0,5,1,0,2,PAN
2018-04-01,97,1,5,6,0,103,PER
2018-04-01,7,0,7,11,0,18,PHL
2018-04-01,3,0,1,1,0,4,PNG
2018-04-01,7,3,0,4,3,11,POL
2018-04-01,1,0,4,4,0,5,PRK
2018-04-01,0,0,1,0,0,0,PRT
2018-04-01,160,0,5,2,0,162,QAT
2018-04-01,8,0,0,0,0,8,ROU
2018-04-01,10,2,5,3,0,13,RUS
2018-04-01,680,23,6,2,0,682,SAU
2018-04-01,1,0,3,0,0,1,SDN
2018-04-01,4,0,0,0,0,4,SEN
2018-04-01,0,0,0,40,0,40,SGP
2018-04-01,0,0,0,1,0,1,SLB
2018-04-01,0,0,1,3,0,3,SLE
2018-04-01,1,0,1,2,0,3,SOM
2018-04-01,0,1,0,0,0,0,SUR
2018-04-01,0,0,1,45,72,45,SWE
2018-04-01,3,0,0,0,0,3,TGO
2018-04-01,407,0,14,123,0,530,THA
2018-04-01,332,7,0,1,0,333,TTO
2018-04-01,13,14,2,0,0,13,TUN
2018-04-01,5,0,10,40,0,45,TUR
2018-04-01,7,5,1,0,2,7,TWN
2018-04-01,2,1,0,0,0,2,TZA
2018-04-01,16,3,3,8,0,24,UKR
2018-04-01,0,0,1,0,0,0,URY
2018-04-01,2388,47,2,538,5,2926,USA
2018-04-01,10,4,2,1,0,11,VEN
2018-04-01,1,0,0,0,0,1,VIR
2018-04-01,43,0,18,106,11,149,VNM
2018-04-01,0,0,1,0,0,0,VUT
2018-04-01,3,0,9,1,0,4,YEM
2018-04-01,1,0,3,1,0,2,ZAF
2018-05-01,2,0,0,0,0,2,ABW
2018-05-01,246,1,0,0,0,246,AGO
2018-05-01,0,1,0,0,0,0,ALB
2018-05-01,539,1,2,9,0,548,ARE
2018-05-01,0,0,1,0,0,0,ASM
2018-05-01,0,0,1,0,0,0,ATG
2018-05-01,60,1,19,38,0,98,AUS
2018-05-01,0,0,1,5,278,5,BEL
2018-05-01,6,0,0,0,0,6,BEN
2018-05-01,0,0,1,0,0,0,BES
2018-05-01,3,1,1,1,0,4,BGD
2018-05-01,1,0,0,0,0,1,BGR
2018-05-01,5,0,2,1,0,6,BHR
2018-05-01,0,0,4,4,0,4,BHS
2018-05-01,0,0,1,0,0,0,BLZ
2018-05-01,144,12,7,12,0,156,BRA
2018-05-01,125,1,0,0,0,125,BRN
2018-05-01,6,0,6,23,0,29,CAN
2018-05-01,0,0,2,0,0,0,CHL
2018-05-01,291,40,102,211,990,502,CHN
2018-05-01,11,0,1,0,0,11,CIV
2018-05-01,73,1,0,0,0,73,CMR
2018-05-01,49,0,0,0,0,49,COD
2018-05-01,81,0,0,0,0,81,COG
2018-05-01,5,0,1,1,0,6,COL
2018-05-01,0,0,0,1,0,1,CRI
2018-05-01,3,0,5,2,0,5,CUB
2018-05-01,0,0,1,0,0,0,CYP
2018-05-01,21,18,2,30,1336,51,DEU
2018-05-01,1,0,1,0,0,1,DJI
2018-05-01,0,0,1,0,0,0,DMA
2018-05-01,18,2,1,21,512,39,DNK
2018-05-01,0,0,1,0,0,0,DOM
2018-05-01,0,0,4,1,0,1,DZA
2018-05-01,10,1,3,1,0,11,ECU
2018-05-01,180,5,0,6,0,186,EGY
2018-05-01,0,0,4,0,0,0,ERI
2018-05-01,3,8,0,5,0,8,ESP
2018-05-01,0,0,0,1,0,1,EST
2018-05-01,0,0,0,54,7,54,FIN
2018-05-01,0,0,4,26,0,26,FRA
2018-05-01,119,0,1,0,0,119,GAB
2018-05-01,164,11,3,16,2044,180,GBR
2018-05-01,1,0,0,0,0,1,GEO
2018-05-01,3,0,4,1,0,4,GHA
2018-05-01,0,0,2,2,0,2,GIN
2018-05-01,0,0,1,0,0,0,GMB
2018-05-01,0,0,2,10,0,10,GNB
2018-05-01,13,0,0,0,0,13,GNQ
2018-05-01,3,0,0,1,0,4,GRC
2018-05-01,0,0,1,0,0,0,GUF
2018-05-01,16,0,0,3,0,19,HRV
2018-05-01,551,76,56,118,0,669,IDN
2018-05-01,176,2,34,13,0,189,IND
2018-05-01,2,0,1,3,7,5,IRL
2018-05-01,160,3,0,1,0,161,IRN
2018-05-01,1,0,0,8,0,9,IRQ
2018-05-01,0,0,0,4,0,4,ISL
2018-05-01,4,0,1,0,0,4,ISR
2018-05-01,103,6,3,5,0,108,ITA
2018-05-01,0,0,0,2,0,2,JEY
2018-05-01,20,7,38,33,0,53,JPN
2018-05-01,0,0,3,1,0,1,KEN
2018-05-01,3,0,1,4,0,7,KHM
2018-05-01,5,0,59,54,9,59,KOR
2018-05-01,31,1,0,27,0,58,KWT
2018-05-01,0,0,1,0,0,0,LBN
2018-05-01,0,0,1,0,0,0,LBR
2018-05-01,12,0,1,0,0,12,LBY
2018-05-01,0,0,4,2,0,2,LKA
2018-05-01,1,0,0,0,0,1,LTU
2018-05-01,0,0,1,0,0,0,LVA
2018-05-01,0,0,1,0,0,0,MDG
2018-05-01,190,3,13,2,0,192,MEX
2018-05-01,4,3,8,7,0,11,MMR
2018-05-01,0,0,0,3,0,3,MOZ
2018-05-01,1,0,3,0,0,1,MRT
2018-05-01,332,30,61,37,0,369,MYS
2018-05-01,9,0,0,0,0,9,NAM
2018-05-01,437,3,2,1,0,438,NGA
2018-05-01,0,0,2,1,0,1,NIC
2018-05-01,114,11,1,5,292,119,NLD
2018-05-01,11,0,1,8,1,19,NOR
2018-05-01,7,0,2,5,0,12,NZL
2018-05-01,17,0,13,1,0,18,None
2018-05-01,6,0,2,0,0,6,OMN
2018-05-01,0,0,2,0,0,0,PAK
2018-05-01,1,0,5,1,0,2,PAN
2018-05-01,99,1,4,7,0,106,PER
2018-05-01,7,0,8,11,0,18,PHL
2018-05-01,3,0,1,1,0,4,PNG
2018-05-01,7,3,0,4,3,11,POL
2018-05-01,1,0,4,4,0,5,PRK
2018-05-01,0,0,1,0,0,0,PRT
2018-05-01,162,0,5,3,0,165,QAT
2018-05-01,8,0,0,0,0,8,ROU
2018-05-01,11,2,5,3,0,14,RUS
2018-05-01,677,26,7,1,0,678,SAU
2018-05-01,1,0,3,0,0,1,SDN
2018-05-01,4,0,0,0,0,4,SEN
2018-05-01,0,0,0,35,0,35,SGP
2018-05-01,0,0,1,3,0,3,SLE
2018-05-01,1,0,1,1,0,2,SOM
2018-05-01,0,1,0,0,0,0,SUR
2018-05-01,0,0,1,47,72,47,SWE
2018-05-01,2,0,0,0,0,2,TGO
2018-05-01,408,0,14,115,0,523,THA
2018-05-01,343,6,0,1,0,344,TTO
2018-05-01,13,14,2,0,0,13,TUN
2018-05-01,5,0,11,40,0,45,TUR
2018-05-01,7,5,1,0,2,7,TWN
2018-05-01,2,1,0,0,0,2,TZA
2018-05-01,16,3,3,8,0,24,UKR
2018-05-01,0,0,1,0,0,0,URY
2018-05-01,2410,45,2,570,5,2980,USA
2018-05-01,10,4,2,1,0,11,VEN
2018-05-01,1,0,0,0,0,1,VIR
2018-05-01,40,0,18,112,13,152,VNM
2018-05-01,0,0,1,0,0,0,VUT
2018-05-01,4,0,8,1,0,5,YEM
2018-05-01,1,0,3,1,0,2,ZAF
2018-06-01,2,0,0,0,0,2,ABW
2018-06-01,245,2,0,0,0,245,AGO
2018-06-01,0,1,0,0,0,0,ALB
2018-06-01,530,1,2,8,0,538,ARE
2018-06-01,0,0,1,0,0,0,ASM
2018-06-01,0,0,1,0,0,0,ATG
2018-06-01,60,1,24,44,0,104,AUS
2018-06-01,0,0,1,5,278,5,BEL
2018-06-01,6,0,0,0,0,6,BEN
2018-06-01,0,0,1,0,0,0,BES
2018-06-01,3,1,1,1,0,4,BGD
2018-06-01,1,0,0,0,0,1,BGR
2018-06-01,5,0,2,1,0,6,BHR
2018-06-01,0,0,4,5,0,5,BHS
2018-06-01,141,12,7,18,0,159,BRA
2018-06-01,123,1,0,0,0,123,BRN
2018-06-01,7,0,5,28,0,35,CAN
2018-06-01,0,0,1,0,0,0,CHL
2018-06-01,286,40,102,221,1027,507,CHN
2018-06-01,11,1,1,0,0,11,CIV
2018-06-01,74,0,0,0,0,74,CMR
2018-06-01,49,0,0,0,0,49,COD
2018-06-01,79,0,0,0,0,79,COG
2018-06-01,5,0,1,0,0,5,COL
2018-06-01,0,0,0,1,0,1,CRI
2018-06-01,3,0,5,2,0,5,CUB
2018-06-01,0,0,1,0,0,0,CYP
2018-06-01,21,18,2,31,1359,52,DEU
2018-06-01,1,0,1,0,0,1,DJI
2018-06-01,0,0,1,0,0,0,DMA
2018-06-01,17,2,1,22,512,39,DNK
2018-06-01,0,0,1,0,0,0,DOM
2018-06-01,0,0,4,1,0,1,DZA
2018-06-01,10,1,4,0,0,10,ECU
2018-06-01,181,5,0,6,0,187,EGY
2018-06-01,0,0,5,1,0,1,ERI
2018-06-01,3,7,0,5,0,8,ESP
2018-06-01,0,0,0,1,0,1,EST
2018-06-01,0,0,0,58,7,58,FIN
2018-06-01,0,0,5,25,0,25,FRA
2018-06-01,119,0,1,0,0,119,GAB
2018-06-01,161,14,3,23,2061,184,GBR
2018-06-01,1,0,0,0,0,1,GEO
2018-06-01,3,0,7,1,0,4,GHA
2018-06-01,0,0,2,1,0,1,GIN
2018-06-01,0,0,1,0,0,0,GMB
2018-06-01,0,0,2,11,0,11,GNB
2018-06-01,13,0,0,0,0,13,GNQ
2018-06-01,3,0,0,2,0,5,GRC
2018-06-01,0,0,1,1,0,1,GUF
2018-06-01,16,0,0,3,0,19,HRV
2018-06-01,554,87,59,124,0,678,IDN
2018-06-01,177,2,35,15,0,192,IND
2018-06-01,3,0,1,3,7,6,IRL
2018-06-01,162,3,0,1,0,163,IRN
2018-06-01,1,0,0,10,0,11,IRQ
2018-06-01,0,0,0,4,0,4,ISL
2018-06-01,4,0,1,0,0,4,ISR
2018-06-01,102,8,4,5,0,107,ITA
2018-06-01,0,0,1,0,0,0,JAM
2018-06-01,0,0,0,2,0,2,JEY
2018-06-01,20,7,38,35,0,55,JPN
2018-06-01,0,0,3,0,0,0,KEN
2018-06-01,3,0,1,5,0,8,KHM
2018-06-01,6,0,63,53,11,59,KOR
2018-06-01,34,2,0,28,0,62,KWT
2018-06-01,0,0,1,0,0,0,LBN
2018-06-01,0,0,1,0,0,0,LBR
2018-06-01,11,0,1,0,0,11,LBY
2018-06-01,0,0,4,2,0,2,LKA
2018-06-01,1,0,0,0,0,1,LTU
2018-06-01,0,0,1,0,0,0,LVA
2018-06-01,0,0,1,0,0,0,MDG
2018-06-01,193,3,13,2,0,195,MEX
2018-06-01,4,3,9,7,0,11,MMR
2018-06-01,0,0,0,3,0,3,MOZ
2018-06-01,0,0,3,0,0,0,MRT
2018-06-01,329,39,51,33,0,362,MYS
2018-06-01,8,0,0,0,0,8,NAM
2018-06-01,301,4,2,1,0,302,NGA
2018-06-01,0,0,2,1,0,1,NIC
2018-06-01,113,12,1,6,292,119,NLD
2018-06-01,12,0,0,9,1,21,NOR
2018-06-01,7,0,2,4,0,11,NZL
2018-06-01,16,1,14,1,0,17,None
2018-06-01,6,0,3,0,0,6,OMN
2018-06-01,0,0,2,0,0,0,PAK
2018-06-01,0,0,6,0,0,0,PAN
2018-06-01,99,1,3,7,0,106,PER
2018-06-01,7,0,9,23,0,30,PHL
2018-06-01,1,0,1,1,0,2,PNG
2018-06-01,9,3,0,5,3,14,POL
2018-06-01,1,0,3,6,0,7,PRK
2018-06-01,0,0,1,0,0,0,PRT
2018-06-01,162,0,5,3,0,165,QAT
2018-06-01,8,1,0,0,0,8,ROU
2018-06-01,13,4,5,4,0,17,RUS
2018-06-01,679,26,8,1,0,680,SAU
2018-06-01,1,0,4,0,0,1,SDN
2018-06-01,4,0,0,0,0,4,SEN
2018-06-01,0,0,0,26,0,26,SGP
2018-06-01,0,0,1,2,0,2,SLE
2018-06-01,0,0,1,1,0,1,SOM
2018-06-01,0,1,0,0,0,0,SUR
2018-06-01,0,0,1,48,72,48,SWE
2018-06-01,2,0,0,0,0,2,TGO
2018-06-01,408,0,14,120,0,528,THA
2018-06-01,348,6,0,1,0,349,TTO
2018-06-01,13,14,2,0,0,13,TUN
2018-06-01,5,0,11,39,0,44,TUR
2018-06-01,7,5,1,0,2,7,TWN
2018-06-01,2,1,0,0,0,2,TZA
2018-06-01,15,4,3,7,0,22,UKR
2018-06-01,0,0,1,0,0,0,URY
2018-06-01,2406,46,2,592,5,2998,USA
2018-06-01,13,4,2,2,0,15,VEN
2018-06-01,1,0,0,0,0,1,VIR
2018-06-01,41,0,19,112,11,153,VNM
2018-06-01,0,0,1,0,0,0,VUT
2018-06-01,2,0,7,1,0,3,YEM
2018-06-01,1,0,3,1,0,2,ZAF
2018-07-01,1,0,0,0,0,1,ABW
2018-07-01,248,2,0,0,0,248,AGO
2018-07-01,0,1,0,0,0,0,ALB
2018-07-01,532,1,3,10,0,542,ARE
2018-07-01,0,0,1,0,0,0,ASM
2018-07-01,0,0,1,0,0,0,ATG
2018-07-01,60,1,25,43,0,103,AUS
2018-07-01,0,0,1,5,278,5,BEL
2018-07-01,7,0,0,0,0,7,BEN
2018-07-01,0,0,1,0,0,0,BES
2018-07-01,3,1,1,1,0,4,BGD
2018-07-01,1,0,0,0,0,1,BGR
2018-07-01,5,0,2,1,0,6,BHR
2018-07-01,0,0,4,5,0,5,BHS
2018-07-01,140,12,8,17,0,157,BRA
2018-07-01,121,2,0,0,0,121,BRN
2018-07-01,7,0,5,29,0,36,CAN
2018-07-01,0,0,1,0,0,0,CHL
2018-07-01,284,43,101,223,1087,507,CHN
2018-07-01,11,1,1,0,0,11,CIV
2018-07-01,72,0,0,0,0,72,CMR
2018-07-01,50,0,0,0,0,50,COD
2018-07-01,79,0,0,0,0,79,COG
2018-07-01,5,0,2,0,0,5,COL
2018-07-01,0,0,0,1,0,1,CRI
2018-07-01,3,0,6,3,0,6,CUB
2018-07-01,0,0,1,0,0,0,CYP
2018-07-01,22,18,2,31,1365,53,DEU
2018-07-01,1,0,1,0,0,1,DJI
2018-07-01,17,2,1,23,512,40,DNK
2018-07-01,0,0,1,0,0,0,DOM
2018-07-01,0,0,4,1,0,1,DZA
2018-07-01,10,1,3,0,0,10,ECU
2018-07-01,181,5,0,6,0,187,EGY
2018-07-01,0,0,5,1,0,1,ERI
2018-07-01,3,7,0,4,0,7,ESP
2018-07-01,0,0,0,1,0,1,EST
2018-07-01,0,0,0,58,6,58,FIN
2018-07-01,0,0,3,25,0,25,FRA
2018-07-01,122,0,1,0,0,122,GAB
2018-07-01,161,15,3,22,2085,183,GBR
2018-07-01,1,0,0,0,0,1,GEO
2018-07-01,2,0,8,2,0,4,GHA
2018-07-01,0,0,2,1,0,1,GIN
2018-07-01,0,0,1,0,0,0,GMB
2018-07-01,0,0,2,10,0,10,GNB
2018-07-01,13,0,0,0,0,13,GNQ
2018-07-01,3,0,0,2,0,5,GRC
2018-07-01,0,0,1,1,0,1,GUF
2018-07-01,16,0,0,3,0,19,HRV
2018-07-01,560,104,63,142,0,702,IDN
2018-07-01,177,2,38,15,0,192,IND
2018-07-01,3,0,1,3,7,6,IRL
2018-07-01,162,3,0,1,0,163,IRN
2018-07-01,1,0,0,10,0,11,IRQ
2018-07-01,0,0,0,4,0,4,ISL
2018-07-01,4,0,1,0,0,4,ISR
2018-07-01,103,9,4,4,0,107,ITA
2018-07-01,0,0,1,0,0,0,JAM
2018-07-01,0,0,0,2,0,2,JEY
2018-07-01,19,6,36,37,0,56,JPN
2018-07-01,0,0,3,0,0,0,KEN
2018-07-01,3,0,1,5,0,8,KHM
2018-07-01,6,0,65,55,12,61,KOR
2018-07-01,35,2,0,29,0,64,KWT
2018-07-01,0,0,1,0,0,0,LBN
2018-07-01,0,0,1,0,0,0,LBR
2018-07-01,12,0,1,0,0,12,LBY
2018-07-01,0,0,4,2,0,2,LKA
2018-07-01,1,0,0,0,0,1,LTU
2018-07-01,0,0,1,0,0,0,LVA
2018-07-01,0,0,1,0,0,0,MDG
2018-07-01,190,3,12,2,0,192,MEX
2018-07-01,4,2,9,9,0,13,MMR
2018-07-01,0,0,0,3,0,3,MOZ
2018-07-01,0,0,3,0,0,0,MRT
2018-07-01,318,40,53,38,0,356,MYS
2018-07-01,6,0,0,0,0,6,NAM
2018-07-01,297,3,1,1,0,298,NGA
2018-07-01,0,0,2,2,0,2,NIC
2018-07-01,111,13,1,4,293,115,NLD
2018-07-01,15,0,0,9,1,24,NOR
2018-07-01,7,0,2,4,0,11,NZL
2018-07-01,16,1,12,1,0,17,None
2018-07-01,6,0,3,0,0,6,OMN
2018-07-01,0,0,2,0,0,0,PAK
2018-07-01,0,0,6,0,0,0,PAN
2018-07-01,96,1,3,7,0,103,PER
2018-07-01,7,0,9,25,0,32,PHL
2018-07-01,1,0,1,1,0,2,PNG
2018-07-01,9,3,0,5,3,14,POL
2018-07-01,1,0,3,6,0,7,PRK
2018-07-01,0,0,1,0,0,0,PRT
2018-07-01,163,0,5,3,0,166,QAT
2018-07-01,8,1,0,0,0,8,ROU
2018-07-01,13,6,4,4,0,17,RUS
2018-07-01,683,26,8,1,0,684,SAU
2018-07-01,1,0,4,0,0,1,SDN
2018-07-01,4,0,0,0,0,4,SEN
2018-07-01,0,0,0,29,0,29,SGP
2018-07-01,0,0,1,2,0,2,SLE
2018-07-01,0,0,1,1,0,1,SOM
2018-07-01,0,1,0,0,0,0,SUR
2018-07-01,0,0,1,49,72,49,SWE
2018-07-01,2,0,0,0,0,2,TGO
2018-07-01,414,0,13,136,0,550,THA
2018-07-01,349,5,0,1,0,350,TTO
2018-07-01,13,14,1,0,0,13,TUN
2018-07-01,5,0,13,39,0,44,TUR
2018-07-01,7,5,1,0,2,7,TWN
2018-07-01,2,1,0,0,0,2,TZA
2018-07-01,14,4,3,7,0,21,UKR
2018-07-01,0,0,1,0,0,0,URY
2018-07-01,2400,45,2,606,5,3006,USA
2018-07-01,11,4,3,4,0,15,VEN
2018-07-01,1,0,0,0,0,1,VIR
2018-07-01,43,0,19,111,11,154,VNM
2018-07-01,0,0,1,0,0,0,VUT
2018-07-01,2,0,8,1,0,3,YEM
2018-07-01,1,0,3,1,0,2,ZAF
2018-08-01,1,0,0,0,0,1,ABW
2018-08-01,249,2,0,0,0,249,AGO
2018-08-01,0,1,0,0,0,0,ALB
2018-08-01,529,1,3,10,0,539,ARE
2018-08-01,0,0,1,0,0,0,ASM
2018-08-01,0,0,1,0,0,0,ATG
2018-08-01,58,1,26,43,0,101,AUS
2018-08-01,0,0,1,5,283,5,BEL
2018-08-01,7,0,0,0,0,7,BEN
2018-08-01,0,0,1,0,0,0,BES
2018-08-01,2,2,1,1,0,3,BGD
2018-08-01,1,0,0,0,0,1,BGR
2018-08-01,5,0,2,1,0,6,BHR
2018-08-01,0,0,3,5,0,5,BHS
2018-08-01,137,13,8,17,0,154,BRA
2018-08-01,123,2,0,0,0,123,BRN
2018-08-01,6,0,7,27,0,33,CAN
2018-08-01,0,0,1,0,0,0,CHL
2018-08-01,284,46,101,232,1113,516,CHN
2018-08-01,11,1,1,0,0,11,CIV
2018-08-01,10,0,0,0,0,10,CMR
2018-08-01,50,0,0,0,0,50,COD
2018-08-01,78,0,0,0,0,78,COG
2018-08-01,5,0,2,0,0,5,COL
2018-08-01,0,0,0,1,0,1,CRI
2018-08-01,3,0,6,3,0,6,CUB
2018-08-01,0,0,1,0,0,0,CYP
2018-08-01,21,18,2,31,1415,52,DEU
2018-08-01,0,0,1,0,0,0,DJI
2018-08-01,18,2,1,24,512,42,DNK
2018-08-01,0,0,1,0,0,0,DOM
2018-08-01,0,0,4,1,0,1,DZA
2018-08-01,10,1,3,0,0,10,ECU
2018-08-01,185,5,1,6,0,191,EGY
2018-08-01,0,0,4,0,0,0,ERI
2018-08-01,3,7,0,5,0,8,ESP
2018-08-01,0,0,0,1,0,1,EST
2018-08-01,0,0,0,54,5,54,FIN
2018-08-01,0,0,4,27,0,27,FRA
2018-08-01,121,0,1,0,0,121,GAB
2018-08-01,166,16,3,22,2108,188,GBR
2018-08-01,1,0,0,0,0,1,GEO
2018-08-01,2,0,10,2,0,4,GHA
2018-08-01,0,0,2,2,0,2,GIN
2018-08-01,0,0,1,0,0,0,GMB
2018-08-01,0,0,2,9,0,9,GNB
2018-08-01,11,0,0,0,0,11,GNQ
2018-08-01,3,0,0,1,0,4,GRC
2018-08-01,0,0,1,1,0,1,GUF
2018-08-01,16,0,0,3,0,19,HRV
2018-08-01,563,102,62,143,0,706,IDN
2018-08-01,177,1,39,15,0,192,IND
2018-08-01,3,0,1,3,7,6,IRL
2018-08-01,159,3,0,1,0,160,IRN
2018-08-01,1,0,0,10,0,11,IRQ
2018-08-01,0,0,0,4,0,4,ISL
2018-08-01,4,0,1,0,0,4,ISR
2018-08-01,104,9,4,4,0,108,ITA
2018-08-01,0,0,1,0,0,0,JAM
2018-08-01,0,0,0,2,0,2,JEY
2018-08-01,19,6,36,40,0,59,JPN
2018-08-01,0,0,3,0,0,0,KEN
2018-08-01,3,0,1,6,0,9,KHM
2018-08-01,6,0,64,55,13,61,KOR
2018-08-01,35,1,0,34,0,69,KWT
2018-08-01,0,0,1,0,0,0,LBN
2018-08-01,0,0,1,0,0,0,LBR
2018-08-01,12,0,1,0,0,12,LBY
2018-08-01,0,0,4,2,0,2,LKA
2018-08-01,1,0,0,0,0,1,LTU
2018-08-01,0,0,1,0,0,0,LVA
2018-08-01,0,0,1,0,0,0,MDG
2018-08-01,189,3,13,1,0,190,MEX
2018-08-01,4,3,8,9,0,13,MMR
2018-08-01,0,0,0,3,0,3,MOZ
2018-08-01,0,0,3,0,0,0,MRT
2018-08-01,317,45,53,42,0,359,MYS
2018-08-01,6,0,0,0,0,6,NAM
2018-08-01,386,1,2,1,0,387,NGA
2018-08-01,0,0,2,2,0,2,NIC
2018-08-01,112,13,1,4,294,116,NLD
2018-08-01,14,0,1,9,1,23,NOR
2018-08-01,7,0,2,4,0,11,NZL
2018-08-01,17,1,12,1,0,18,None
2018-08-01,7,0,3,0,0,7,OMN
2018-08-01,0,0,2,0,0,0,PAK
2018-08-01,0,0,7,0,0,0,PAN
2018-08-01,97,1,3,4,0,101,PER
2018-08-01,7,0,12,30,0,37,PHL
2018-08-01,3,0,0,1,0,4,PNG
2018-08-01,9,3,0,5,3,14,POL
2018-08-01,1,0,3,5,0,6,PRK
2018-08-01,0,0,1,0,0,0,PRT
2018-08-01,161,0,4,2,0,163,QAT
2018-08-01,8,0,0,0,0,8,ROU
2018-08-01,13,6,4,4,0,17,RUS
2018-08-01,686,28,8,1,0,687,SAU
2018-08-01,0,0,3,0,0,0,SDN
2018-08-01,3,0,0,0,0,3,SEN
2018-08-01,0,0,0,32,0,32,SGP
2018-08-01,0,0,1,0,0,0,SLB
2018-08-01,0,0,1,3,0,3,SLE
2018-08-01,0,0,0,1,0,1,SLV
2018-08-01,0,0,1,1,0,1,SOM
2018-08-01,0,1,0,0,0,0,SUR
2018-08-01,0,0,1,49,72,49,SWE
2018-08-01,2,0,0,0,0,2,TGO
2018-08-01,415,0,14,144,0,559,THA
2018-08-01,341,5,0,1,0,342,TTO
2018-08-01,13,14,1,0,0,13,TUN
2018-08-01,5,0,13,42,0,47,TUR
2018-08-01,7,6,1,0,2,7,TWN
2018-08-01,2,1,0,0,0,2,TZA
2018-08-01,15,4,3,6,0,21,UKR
2018-08-01,0,0,1,0,0,0,URY
2018-08-01,2367,44,2,592,5,2959,USA
2018-08-01,10,3,3,4,0,14,VEN
2018-08-01,1,0,0,0,0,1,VIR
2018-08-01,43,0,18,111,12,154,VNM
2018-08-01,0,0,1,0,0,0,VUT
2018-08-01,2,0,9,1,0,3,YEM
2018-08-01,1,0,3,1,0,2,ZAF
2018-09-01,1,0,0,0,0,1,ABW
2018-09-01,248,2,0,0,0,248,AGO
2018-09-01,0,1,0,0,0,0,ALB
2018-09-01,527,1,2,10,0,537,ARE
2018-09-01,0,0,1,0,0,0,ASM
2018-09-01,0,0,1,0,0,0,ATG
2018-09-01,60,1,27,46,0,106,AUS
2018-09-01,0,0,1,5,294,5,BEL
2018-09-01,6,0,0,0,0,6,BEN
2018-09-01,0,0,1,0,0,0,BES
2018-09-01,2,2,0,1,0,3,BGD
2018-09-01,1,0,0,0,0,1,BGR
2018-09-01,5,0,2,1,0,6,BHR
2018-09-01,0,0,3,4,0,4,BHS
2018-09-01,136,12,8,16,0,152,BRA
2018-09-01,123,3,0,0,0,123,BRN
2018-09-01,6,0,7,21,0,27,CAN
2018-09-01,0,0,2,0,0,0,CHL
2018-09-01,290,42,103,232,1147,522,CHN
2018-09-01,11,1,1,0,0,11,CIV
2018-09-01,10,0,0,0,0,10,CMR
2018-09-01,49,0,0,0,0,49,COD
2018-09-01,79,0,0,0,0,79,COG
2018-09-01,5,0,2,0,0,5,COL
2018-09-01,0,0,0,1,0,1,CRI
2018-09-01,3,0,5,3,0,6,CUB
2018-09-01,0,0,1,0,0,0,CYP
2018-09-01,21,18,2,31,1425,52,DEU
2018-09-01,0,0,1,0,0,0,DJI
2018-09-01,18,2,1,22,512,40,DNK
2018-09-01,0,0,1,0,0,0,DOM
2018-09-01,0,0,4,1,0,1,DZA
2018-09-01,10,1,2,0,0,10,ECU
2018-09-01,188,6,1,6,0,194,EGY
2018-09-01,0,0,3,0,0,0,ERI
2018-09-01,3,7,0,5,0,8,ESP
2018-09-01,0,0,1,1,0,1,EST
2018-09-01,0,0,0,55,5,55,FIN
2018-09-01,0,0,4,27,0,27,FRA
2018-09-01,121,0,1,0,0,121,GAB
2018-09-01,168,16,3,19,2128,187,GBR
2018-09-01,1,0,0,0,0,1,GEO
2018-09-01,2,0,10,2,0,4,GHA
2018-09-01,0,0,2,2,0,2,GIN
2018-09-01,0,0,1,0,0,0,GMB
2018-09-01,0,0,2,7,0,7,GNB
2018-09-01,11,0,0,0,0,11,GNQ
2018-09-01,4,0,0,1,0,5,GRC
2018-09-01,0,0,1,1,0,1,GUF
2018-09-01,16,0,0,3,0,19,HRV
2018-09-01,558,91,63,144,0,702,IDN
2018-09-01,175,1,38,13,0,188,IND
2018-09-01,3,0,1,3,7,6,IRL
2018-09-01,158,2,0,1,0,159,IRN
2018-09-01,1,0,0,9,0,10,IRQ
2018-09-01,0,0,0,3,0,3,ISL
2018-09-01,4,0,1,0,0,4,ISR
2018-09-01,103,8,4,4,0,107,ITA
2018-09-01,0,0,1,0,0,0,JAM
2018-09-01,0,0,0,1,0,1,JEY
2018-09-01,19,7,35,42,0,61,JPN
2018-09-01,0,0,3,0,0,0,KEN
2018-09-01,3,0,1,6,0,9,KHM
2018-09-01,6,0,62,55,13,61,KOR
2018-09-01,33,1,0,33,0,66,KWT
2018-09-01,0,0,1,0,0,0,LBN
2018-09-01,0,0,1,0,0,0,LBR
2018-09-01,13,0,1,0,0,13,LBY
2018-09-01,0,0,4,2,0,2,LKA
2018-09-01,1,0,0,0,0,1,LTU
2018-09-01,0,0,1,0,0,0,LVA
2018-09-01,0,0,1,0,0,0,MDG
2018-09-01,191,3,13,1,0,192,MEX
2018-09-01,5,3,8,9,0,14,MMR
2018-09-01,0,0,0,3,0,3,MOZ
2018-09-01,0,0,3,0,0,0,MRT
2018-09-01,318,43,48,38,0,356,MYS
2018-09-01,6,0,0,0,0,6,NAM
2018-09-01,391,2,2,1,0,392,NGA
2018-09-01,0,0,2,2,0,2,NIC
2018-09-01,115,12,1,4,295,119,NLD
2018-09-01,16,0,1,10,1,26,NOR
2018-09-01,7,0,3,5,0,12,NZL
2018-09-01,18,0,11,1,0,19,None
2018-09-01,8,0,3,0,0,8,OMN
2018-09-01,0,0,2,0,0,0,PAK
2018-09-01,0,1,7,0,0,0,PAN
2018-09-01,98,1,3,3,0,101,PER
2018-09-01,7,0,12,28,0,35,PHL
2018-09-01,3,0,0,1,0,4,PNG
2018-09-01,9,3,0,5,3,14,POL
2018-09-01,1,0,2,5,0,6,PRK
2018-09-01,0,0,1,0,0,0,PRT
2018-09-01,162,0,3,2,0,164,QAT
2018-09-01,8,0,0,0,0,8,ROU
2018-09-01,13,3,4,4,0,17,RUS
2018-09-01,689,28,8,1,0,690,SAU
2018-09-01,0,0,3,0,0,0,SDN
2018-09-01,3,0,0,0,0,3,SEN
2018-09-01,0,0,0,27,0,27,SGP
2018-09-01,0,0,1,0,0,0,SLB
2018-09-01,0,0,1,3,0,3,SLE
2018-09-01,0,0,0,1,0,1,SLV
2018-09-01,0,0,1,1,0,1,SOM
2018-09-01,0,1,0,0,0,0,SUR
2018-09-01,0,0,1,48,72,48,SWE
2018-09-01,2,0,0,0,0,2,TGO
2018-09-01,418,0,14,144,0,562,THA
2018-09-01,338,4,0,1,0,339,TTO
2018-09-01,13,16,1,0,0,13,TUN
2018-09-01,5,0,12,43,0,48,TUR
2018-09-01,7,6,1,0,2,7,TWN
2018-09-01,2,0,0,0,0,2,TZA
2018-09-01,15,5,3,6,0,21,UKR
2018-09-01,0,0,1,0,0,0,URY
2018-09-01,2320,45,1,583,5,2903,USA
2018-09-01,13,3,2,5,0,18,VEN
2018-09-01,1,0,0,0,0,1,VIR
2018-09-01,41,0,18,117,10,158,VNM
2018-09-01,0,0,1,0,0,0,VUT
2018-09-01,2,0,8,1,0,3,YEM
2018-09-01,1,0,3,1,0,2,ZAF
2018-10-01,245,2,0,0,0,245,AGO
2018-10-01,0,1,0,0,0,0,ALB
2018-10-01,517,1,2,10,0,527,ARE
2018-10-01,0,0,1,0,0,0,ASM
2018-10-01,0,0,1,0,0,0,ATG
2018-10-01,60,1,29,48,0,108,AUS
2018-10-01,0,0,1,5,300,5,BEL
2018-10-01,6,0,0,0,0,6,BEN
2018-10-01,0,0,1,0,0,0,BES
2018-10-01,3,2,0,1,0,4,BGD
2018-10-01,1,0,0,0,0,1,BGR
2018-10-01,7,0,2,1,0,8,BHR
2018-10-01,0,0,4,4,0,4,BHS
2018-10-01,135,13,7,16,0,151,BRA
2018-10-01,124,3,0,0,0,124,BRN
2018-10-01,5,0,7,20,0,25,CAN
2018-10-01,0,0,2,0,0,0,CHL
2018-10-01,291,39,103,222,1189,513,CHN
2018-10-01,11,1,1,0,0,11,CIV
2018-10-01,73,0,0,0,0,73,CMR
2018-10-01,50,0,0,0,0,50,COD
2018-10-01,78,0,0,0,0,78,COG
2018-10-01,5,0,2,0,0,5,COL
2018-10-01,3,0,4,2,0,5,CUB
2018-10-01,0,0,1,0,0,0,CYM
2018-10-01,0,0,1,0,0,0,CYP
2018-10-01,21,17,2,31,1435,52,DEU
2018-10-01,0,0,1,0,0,0,DJI
2018-10-01,18,2,1,22,512,40,DNK
2018-10-01,0,0,1,0,0,0,DOM
2018-10-01,0,0,4,0,0,0,DZA
2018-10-01,10,1,2,0,0,10,ECU
2018-10-01,190,5,2,6,0,196,EGY
2018-10-01,0,0,3,0,0,0,ERI
2018-10-01,3,7,0,5,0,8,ESP
2018-10-01,0,0,1,1,0,1,EST
2018-10-01,0,0,0,56,5,56,FIN
2018-10-01,0,0,1,0,0,0,FJI
2018-10-01,0,0,3,26,0,26,FRA
2018-10-01,121,0,1,0,0,121,GAB
2018-10-01,172,14,4,20,2174,192,GBR
2018-10-01,1,0,0,0,0,1,GEO
2018-10-01,2,0,11,2,0,4,GHA
2018-10-01,0,0,2,2,0,2,GIN
2018-10-01,0,0,0,1,0,1,GLP
2018-10-01,0,0,2,0,0,0,GMB
2018-10-01,0,0,1,7,0,7,GNB
2018-10-01,13,0,0,0,0,13,GNQ
2018-10-01,4,0,0,3,0,7,GRC
2018-10-01,0,0,1,1,0,1,GUF
2018-10-01,16,0,0,3,0,19,HRV
2018-10-01,556,81,65,137,0,693,IDN
2018-10-01,176,1,35,13,0,189,IND
2018-10-01,3,0,1,3,7,6,IRL
2018-10-01,157,2,0,1,0,158,IRN
2018-10-01,1,0,0,9,0,10,IRQ
2018-10-01,0,0,0,2,0,2,ISL
2018-10-01,5,0,1,0,0,5,ISR
2018-10-01,103,8,4,4,0,107,ITA
2018-10-01,0,0,1,0,0,0,JAM
2018-10-01,0,0,0,1,0,1,JEY
2018-10-01,18,7,38,34,0,52,JPN
2018-10-01,0,0,3,0,0,0,KEN
2018-10-01,3,0,1,6,0,9,KHM
2018-10-01,6,0,60,53,13,59,KOR
2018-10-01,34,1,0,30,0,64,KWT
2018-10-01,0,0,1,0,0,0,LBN
2018-10-01,0,0,1,2,0,2,LBR
2018-10-01,12,0,1,0,0,12,LBY
2018-10-01,0,0,3,1,0,1,LKA
2018-10-01,1,0,0,0,0,1,LTU
2018-10-01,0,0,1,0,0,0,LVA
2018-10-01,0,0,1,0,0,0,MDG
2018-10-01,190,3,13,1,0,191,MEX
2018-10-01,5,3,8,10,0,15,MMR
2018-10-01,0,0,0,3,0,3,MOZ
2018-10-01,0,0,3,0,0,0,MRT
2018-10-01,318,42,46,33,0,351,MYS
2018-10-01,6,0,0,0,0,6,NAM
2018-10-01,431,3,2,1,0,432,NGA
2018-10-01,0,0,2,2,0,2,NIC
2018-10-01,115,12,1,3,293,118,NLD
2018-10-01,14,0,0,9,1,23,NOR
2018-10-01,7,0,2,5,0,12,NZL
2018-10-01,18,0,11,1,0,19,None
2018-10-01,8,0,4,0,0,8,OMN
2018-10-01,0,0,2,0,0,0,PAK
2018-10-01,0,1,6,0,0,0,PAN
2018-10-01,99,1,4,2,0,101,PER
2018-10-01,7,0,8,25,0,32,PHL
2018-10-01,4,0,0,1,0,5,PNG
2018-10-01,9,3,0,5,3,14,POL
2018-10-01,1,0,2,5,0,6,PRK
2018-10-01,0,0,1,0,0,0,PRT
2018-10-01,163,0,3,2,0,165,QAT
2018-10-01,8,0,0,0,0,8,ROU
2018-10-01,12,3,5,4,0,16,RUS
2018-10-01,695,26,8,1,0,696,SAU
2018-10-01,0,0,3,0,0,0,SDN
2018-10-01,2,0,0,0,0,2,SEN
2018-10-01,0,0,0,20,0,20,SGP
2018-10-01,0,0,1,0,0,0,SLB
2018-10-01,0,0,1,3,0,3,SLE
2018-10-01,0,0,0,1,0,1,SLV
2018-10-01,0,0,1,1,0,1,SOM
2018-10-01,0,1,0,0,0,0,SUR
2018-10-01,0,0,1,50,68,50,SWE
2018-10-01,3,0,0,0,0,3,TGO
2018-10-01,420,1,15,146,0,566,THA
2018-10-01,339,4,0,1,0,340,TTO
2018-10-01,14,17,1,0,0,14,TUN
2018-10-01,5,0,13,41,0,46,TUR
2018-10-01,7,7,1,0,2,7,TWN
2018-10-01,2,0,0,0,0,2,TZA
2018-10-01,14,5,3,7,0,21,UKR
2018-10-01,0,0,1,0,0,0,URY
2018-10-01,2301,48,1,578,5,2879,USA
2018-10-01,15,2,2,5,0,20,VEN
2018-10-01,1,0,0,0,0,1,VIR
2018-10-01,40,1,19,116,10,156,VNM
2018-10-01,0,0,1,0,0,0,VUT
2018-10-01,2,0,11,1,0,3,YEM
2018-10-01,1,0,3,1,0,2,ZAF
2018-11-01,245,1,0,0,0,245,AGO
2018-11-01,0,1,0,0,0,0,ALB
2018-11-01,515,1,2,11,0,526,ARE
2018-11-01,0,0,1,0,0,0,ASM
2018-11-01,0,0,1,0,0,0,ATG
2018-11-01,61,1,32,45,0,106,AUS
2018-11-01,0,0,1,5,311,5,BEL
2018-11-01,6,0,0,0,0,6,BEN
2018-11-01,0,0,1,0,0,0,BES
2018-11-01,3,2,0,1,0,4,BGD
2018-11-01,1,0,0,0,0,1,BGR
2018-11-01,7,0,1,1,0,8,BHR
2018-11-01,0,0,4,4,0,4,BHS
2018-11-01,132,13,9,20,0,152,BRA
2018-11-01,122,4,0,0,0,122,BRN
2018-11-01,5,0,6,17,0,22,CAN
2018-11-01,0,0,2,0,0,0,CHL
2018-11-01,289,44,99,225,1265,514,CHN
2018-11-01,11,1,1,0,0,11,CIV
2018-11-01,74,0,0,0,0,74,CMR
2018-11-01,50,0,0,0,0,50,COD
2018-11-01,77,0,0,0,0,77,COG
2018-11-01,5,0,2,0,0,5,COL
2018-11-01,3,0,5,2,0,5,CUB
2018-11-01,0,0,1,0,0,0,CYM
2018-11-01,0,0,1,0,0,0,CYP
2018-11-01,21,17,2,31,1450,52,DEU
2018-11-01,1,0,1,0,0,1,DJI
2018-11-01,18,2,1,22,512,40,DNK
2018-11-01,0,0,1,0,0,0,DOM
2018-11-01,0,0,4,0,0,0,DZA
2018-11-01,10,1,3,0,0,10,ECU
2018-11-01,183,5,2,6,0,189,EGY
2018-11-01,0,0,5,0,0,0,ERI
2018-11-01,3,7,0,5,0,8,ESP
2018-11-01,0,0,1,1,0,1,EST
2018-11-01,0,0,1,59,5,59,FIN
2018-11-01,0,0,1,0,0,0,FJI
2018-11-01,0,0,3,22,0,22,FRA
2018-11-01,117,0,1,0,0,117,GAB
2018-11-01,175,14,4,20,2183,195,GBR
2018-11-01,1,0,0,0,0,1,GEO
2018-11-01,2,0,9,1,0,3,GHA
2018-11-01,0,0,3,2,0,2,GIN
2018-11-01,0,0,0,1,0,1,GLP
2018-11-01,0,0,2,0,0,0,GMB
2018-11-01,0,0,2,9,0,9,GNB
2018-11-01,13,0,0,0,0,13,GNQ
2018-11-01,4,0,0,3,0,7,GRC
2018-11-01,0,0,1,0,0,0,GUF
2018-11-01,16,0,0,3,0,19,HRV
2018-11-01,562,82,62,147,0,709,IDN
2018-11-01,177,1,37,12,0,189,IND
2018-11-01,3,0,1,3,7,6,IRL
2018-11-01,157,2,0,1,0,158,IRN
2018-11-01,1,0,0,8,0,9,IRQ
2018-11-01,0,0,0,2,0,2,ISL
2018-11-01,5,0,1,0,0,5,ISR
2018-11-01,102,8,3,6,0,108,ITA
2018-11-01,0,0,1,0,0,0,JAM
2018-11-01,0,0,0,1,0,1,JEY
2018-11-01,18,12,35,32,0,50,JPN
2018-11-01,0,0,3,0,0,0,KEN
2018-11-01,3,0,1,6,0,9,KHM
2018-11-01,6,0,59,54,13,60,KOR
2018-11-01,32,1,0,27,0,59,KWT
2018-11-01,0,0,1,0,0,0,LBN
2018-11-01,0,0,1,2,0,2,LBR
2018-11-01,12,0,1,0,0,12,LBY
2018-11-01,0,0,3,1,0,1,LKA
2018-11-01,1,0,0,0,0,1,LTU
2018-11-01,0,0,1,0,0,0,LVA
2018-11-01,0,0,1,0,0,0,MDG
2018-11-01,190,3,13,3,0,193,MEX
2018-11-01,4,3,13,10,0,14,MMR
2018-11-01,0,0,0,3,0,3,MOZ
2018-11-01,0,0,3,0,0,0,MRT
2018-11-01,325,48,51,41,0,366,MYS
2018-11-01,6,0,0,0,0,6,NAM
2018-11-01,432,3,2,1,0,433,NGA
2018-11-01,0,0,2,2,0,2,NIC
2018-11-01,116,12,1,3,293,119,NLD
2018-11-01,18,0,0,8,1,26,NOR
2018-11-01,7,0,2,5,0,12,NZL
2018-11-01,18,0,12,1,0,19,None
2018-11-01,6,0,4,0,0,6,OMN
2018-11-01,0,0,2,0,0,0,PAK
2018-11-01,0,1,6,0,0,0,PAN
2018-11-01,99,1,4,1,0,100,PER
2018-11-01,7,0,11,24,0,31,PHL
2018-11-01,4,0,1,1,0,5,PNG
2018-11-01,9,3,0,5,3,14,POL
2018-11-01,1,0,2,5,0,6,PRK
2018-11-01,0,0,1,0,0,0,PRT
2018-11-01,164,0,2,3,0,167,QAT
2018-11-01,8,0,0,0,0,8,ROU
2018-11-01,10,3,6,4,0,14,RUS
2018-11-01,700,24,7,1,0,701,SAU
2018-11-01,2,0,3,0,0,2,SDN
2018-11-01,2,0,0,0,0,2,SEN
2018-11-01,0,0,0,25,0,25,SGP
2018-11-01,0,0,1,0,0,0,SLB
2018-11-01,0,0,1,3,0,3,SLE
2018-11-01,0,0,1,1,0,1,SOM
2018-11-01,0,1,0,0,0,0,SUR
2018-11-01,0,0,1,51,65,51,SWE
2018-11-01,3,0,0,0,0,3,TGO
2018-11-01,420,1,16,149,0,569,THA
2018-11-01,343,3,0,1,0,344,TTO
2018-11-01,14,15,1,0,0,14,TUN
2018-11-01,5,0,14,41,0,46,TUR
2018-11-01,7,7,1,0,2,7,TWN
2018-11-01,2,0,0,0,0,2,TZA
2018-11-01,13,5,3,7,0,20,UKR
2018-11-01,0,0,1,0,0,0,URY
2018-11-01,2288,47,1,566,5,2854,USA
2018-11-01,14,3,2,5,0,19,VEN
2018-11-01,1,0,0,0,0,1,VIR
2018-11-01,41,1,18,112,12,153,VNM
2018-11-01,0,0,1,0,0,0,VUT
2018-11-01,2,0,13,1,0,3,YEM
2018-11-01,1,0,3,1,0,2,ZAF
2018-12-01,244,1,0,0,0,244,AGO
2018-12-01,0,1,0,0,0,0,ALB
2018-12-01,514,0,2,12,0,526,ARE
2018-12-01,0,0,1,0,0,0,ASM
2018-12-01,0,0,1,0,0,0,ATG
2018-12-01,60,2,32,47,0,107,AUS
2018-12-01,0,0,1,5,321,5,BEL
2018-12-01,6,0,0,0,0,6,BEN
2018-12-01,0,0,1,0,0,0,BES
2018-12-01,3,1,0,0,0,3,BGD
2018-12-01,1,0,0,0,0,1,BGR
2018-12-01,6,0,1,1,0,7,BHR
2018-12-01,0,0,3,4,0,4,BHS
2018-12-01,131,12,8,20,0,151,BRA
2018-12-01,123,4,0,0,0,123,BRN
2018-12-01,5,0,6,10,0,15,CAN
2018-12-01,0,0,2,0,0,0,CHL
2018-12-01,295,46,105,240,1318,535,CHN
2018-12-01,11,1,1,0,0,11,CIV
2018-12-01,74,0,0,0,0,74,CMR
2018-12-01,50,0,0,0,0,50,COD
2018-12-01,75,0,0,0,0,75,COG
2018-12-01,5,0,2,0,0,5,COL
2018-12-01,3,0,5,2,0,5,CUB
2018-12-01,0,0,1,0,0,0,CYM
2018-12-01,0,0,1,0,0,0,CYP
2018-12-01,21,17,2,31,1469,52,DEU
2018-12-01,2,0,1,0,0,2,DJI
2018-12-01,18,2,0,23,512,41,DNK
2018-12-01,0,0,1,0,0,0,DOM
2018-12-01,0,0,4,0,0,0,DZA
2018-12-01,10,1,3,0,0,10,ECU
2018-12-01,183,5,2,6,0,189,EGY
2018-12-01,0,0,5,0,0,0,ERI
2018-12-01,3,8,0,5,0,8,ESP
2018-12-01,0,0,1,1,0,1,EST
2018-12-01,0,0,1,56,5,56,FIN
2018-12-01,0,0,1,0,0,0,FJI
2018-12-01,0,0,2,22,0,22,FRA
2018-12-01,118,0,1,0,0,118,GAB
2018-12-01,175,13,4,21,2129,196,GBR
2018-12-01,1,0,0,0,0,1,GEO
2018-12-01,2,0,6,1,0,3,GHA
2018-12-01,0,0,3,2,0,2,GIN
2018-12-01,0,0,2,0,0,0,GMB
2018-12-01,0,0,2,9,0,9,GNB
2018-12-01,13,0,0,0,0,13,GNQ
2018-12-01,4,0,0,3,0,7,GRC
2018-12-01,0,0,1,0,0,0,GUF
2018-12-01,0,0,1,0,0,0,GUY
2018-12-01,16,0,0,3,0,19,HRV
2018-12-01,556,79,61,154,0,710,IDN
2018-12-01,178,3,36,14,0,192,IND
2018-12-01,2,0,1,3,7,5,IRL
2018-12-01,155,2,0,1,0,156,IRN
2018-12-01,1,0,0,9,0,10,IRQ
2018-12-01,0,0,0,2,0,2,ISL
2018-12-01,5,0,1,0,0,5,ISR
2018-12-01,102,8,3,6,0,108,ITA
2018-12-01,0,0,1,0,0,0,JAM
2018-12-01,0,0,0,1,0,1,JEY
2018-12-01,18,13,36,33,0,51,JPN
2018-12-01,0,0,3,0,0,0,KEN
2018-12-01,3,0,1,5,0,8,KHM
2018-12-01,6,0,58,51,12,57,KOR
2018-12-01,32,1,0,31,0,63,KWT
2018-12-01,0,0,1,0,0,0,LBN
2018-12-01,0,0,2,2,0,2,LBR
2018-12-01,12,0,1,0,0,12,LBY
2018-12-01,0,0,3,1,0,1,LKA
2018-12-01,1,0,0,0,0,1,LTU
2018-12-01,0,0,1,0,0,0,LVA
2018-12-01,0,0,1,0,0,0,MDG
2018-12-01,193,2,13,3,0,196,MEX
2018-12-01,4,4,19,10,0,14,MMR
2018-12-01,0,0,0,3,0,3,MOZ
2018-12-01,0,0,3,0,0,0,MRT
2018-12-01,328,50,53,46,0,374,MYS
2018-12-01,8,0,0,0,0,8,NAM
2018-12-01,437,3,3,1,0,438,NGA
2018-12-01,0,0,2,2,0,2,NIC
2018-12-01,117,12,1,4,293,121,NLD
2018-12-01,20,0,0,7,1,27,NOR
2018-12-01,7,0,2,5,0,12,NZL
2018-12-01,19,0,10,3,0,22,None
2018-12-01,6,0,3,0,0,6,OMN
2018-12-01,0,0,2,0,0,0,PAK
2018-12-01,0,1,6,0,0,0,PAN
2018-12-01,99,1,6,1,0,100,PER
2018-12-01,7,0,11,24,0,31,PHL
2018-12-01,4,0,1,1,0,5,PNG
2018-12-01,9,3,0,5,3,14,POL
2018-12-01,1,0,2,3,0,4,PRK
2018-12-01,0,0,1,0,0,0,PRT
2018-12-01,164,0,2,3,0,167,QAT
2018-12-01,8,0,0,0,0,8,ROU
2018-12-01,8,3,6,3,0,11,RUS
2018-12-01,703,24,8,2,0,705,SAU
2018-12-01,2,0,3,0,0,2,SDN
2018-12-01,3,0,0,0,0,3,SEN
2018-12-01,0,0,0,37,0,37,SGP
2018-12-01,0,0,1,0,0,0,SLB
2018-12-01,0,0,1,3,0,3,SLE
2018-12-01,0,0,1,1,0,1,SOM
2018-12-01,0,1,0,0,0,0,SUR
2018-12-01,0,0,1,50,65,50,SWE
2018-12-01,3,0,0,0,0,3,TGO
2018-12-01,420,1,16,159,0,579,THA
2018-12-01,338,3,0,1,0,339,TTO
2018-12-01,14,16,1,0,0,14,TUN
2018-12-01,6,0,13,43,0,49,TUR
2018-12-01,7,7,1,0,2,7,TWN
2018-12-01,2,0,0,0,0,2,TZA
2018-12-01,14,5,3,6,0,20,UKR
2018-12-01,0,0,1,0,0,0,URY
2018-12-01,2276,45,1,565,5,2841,USA
2018-12-01,14,3,2,5,0,19,VEN
2018-12-01,1,0,0,0,0,1,VIR
2018-12-01,40,1,17,116,12,156,VNM
2018-12-01,0,0,1,0,0,0,VUT
2018-12-01,4,0,13,0,0,4,YEM
2018-12-01,1,0,3,1,0,2,ZAF
2019-01-01,1,0,0,0,0,1,ABW
2019-01-01,244,2,0,0,0,244,AGO
2019-01-01,0,1,0,0,0,0,ALB
2019-01-01,511,0,2,11,0,522,ARE
2019-01-01,0,0,1,0,0,0,ASM
2019-01-01,0,0,1,0,0,0,ATG
2019-01-01,61,2,33,57,0,118,AUS
2019-01-01,0,0,1,5,321,5,BEL
2019-01-01,7,0,0,0,0,7,BEN
2019-01-01,0,0,1,0,0,0,BES
2019-01-01,3,1,0,0,0,3,BGD
2019-01-01,1,0,0,0,0,1,BGR
2019-01-01,6,0,1,1,0,7,BHR
2019-01-01,0,0,3,4,0,4,BHS
2019-01-01,135,11,7,20,0,155,BRA
2019-01-01,123,4,0,0,0,123,BRN
2019-01-01,5,0,6,7,0,12,CAN
2019-01-01,0,0,2,0,0,0,CHL
2019-01-01,298,50,109,252,1385,550,CHN
2019-01-01,12,1,1,0,0,12,CIV
2019-01-01,74,0,0,0,0,74,CMR
2019-01-01,50,0,0,0,0,50,COD
2019-01-01,75,0,0,0,0,75,COG
2019-01-01,6,0,2,0,0,6,COL
2019-01-01,3,0,5,2,0,5,CUB
2019-01-01,22,18,2,31,1476,53,DEU
2019-01-01,2,0,1,0,0,2,DJI
2019-01-01,19,2,0,23,513,42,DNK
2019-01-01,0,0,1,0,0,0,DOM
2019-01-01,0,0,4,0,0,0,DZA
2019-01-01,10,1,3,0,0,10,ECU
2019-01-01,181,6,1,7,0,188,EGY
2019-01-01,0,0,4,0,0,0,ERI
2019-01-01,3,8,0,5,0,8,ESP
2019-01-01,0,0,0,1,0,1,EST
2019-01-01,0,0,1,52,6,52,FIN
2019-01-01,0,0,1,1,0,1,FJI
2019-01-01,0,0,2,25,0,25,FRA
2019-01-01,118,0,1,0,0,118,GAB
2019-01-01,177,10,4,18,2133,195,GBR
2019-01-01,1,0,0,0,0,1,GEO
2019-01-01,2,0,5,1,0,3,GHA
2019-01-01,0,0,3,2,0,2,GIN
2019-01-01,0,0,2,0,0,0,GMB
2019-01-01,0,0,2,8,0,8,GNB
2019-01-01,13,0,0,0,0,13,GNQ
2019-01-01,5,0,0,4,0,9,GRC
2019-01-01,0,0,1,0,0,0,GUF
2019-01-01,0,0,1,0,0,0,GUY
2019-01-01,16,0,0,3,0,19,HRV
2019-01-01,556,90,65,148,0,704,IDN
2019-01-01,183,3,36,15,0,198,IND
2019-01-01,2,0,1,3,7,5,IRL
2019-01-01,162,2,0,1,0,163,IRN
2019-01-01,1,0,0,9,0,10,IRQ
2019-01-01,0,0,0,2,0,2,ISL
2019-01-01,4,0,1,0,0,4,ISR
2019-01-01,101,8,3,6,0,107,ITA
2019-01-01,0,0,1,0,0,0,JAM
2019-01-01,0,0,0,1,0,1,JEY
2019-01-01,18,14,38,33,0,51,JPN
2019-01-01,0,0,3,0,0,0,KEN
2019-01-01,3,0,1,5,0,8,KHM
2019-01-01,6,0,57,52,12,58,KOR
2019-01-01,32,0,0,31,0,63,KWT
2019-01-01,0,0,1,0,0,0,LBN
2019-01-01,0,0,3,1,0,1,LBR
2019-01-01,11,0,1,0,0,11,LBY
2019-01-01,0,0,3,1,0,1,LKA
2019-01-01,1,0,0,0,0,1,LTU
2019-01-01,0,0,1,0,0,0,LVA
2019-01-01,0,0,1,0,0,0,MDG
2019-01-01,192,2,13,2,0,194,MEX
2019-01-01,4,5,17,9,0,13,MMR
2019-01-01,0,0,0,2,0,2,MOZ
2019-01-01,0,0,3,0,0,0,MRT
2019-01-01,327,58,54,48,0,375,MYS
2019-01-01,8,0,0,0,0,8,NAM
2019-01-01,0,0,0,1,0,1,NCL
2019-01-01,440,3,3,1,0,441,NGA
2019-01-01,0,0,2,2,0,2,NIC
2019-01-01,118,12,1,4,293,122,NLD
2019-01-01,19,0,0,7,1,26,NOR
2019-01-01,7,0,2,6,0,13,NZL
2019-01-01,17,0,11,3,0,20,None
2019-01-01,6,0,3,0,0,6,OMN
2019-01-01,0,0,2,0,0,0,PAK
2019-01-01,0,1,5,0,0,0,PAN
2019-01-01,96,1,5,1,0,97,PER
2019-01-01,7,0,12,34,0,41,PHL
2019-01-01,4,0,1,1,0,5,PNG
2019-01-01,9,3,0,5,3,14,POL
2019-01-01,1,0,2,3,0,4,PRK
2019-01-01,0,0,1,1,0,1,PRT
2019-01-01,164,0,2,3,0,167,QAT
2019-01-01,8,0,0,0,0,8,ROU
2019-01-01,8,2,6,4,0,12,RUS
2019-01-01,697,27,9,4,0,701,SAU
2019-01-01,3,0,0,0,0,3,SEN
2019-01-01,0,0,0,39,0,39,SGP
2019-01-01,0,0,1,0,0,0,SLB
2019-01-01,0,0,2,4,0,4,SLE
2019-01-01,0,0,1,1,0,1,SOM
2019-01-01,0,1,0,0,0,0,SUR
2019-01-01,0,0,1,47,65,47,SWE
2019-01-01,3,0,0,0,0,3,TGO
2019-01-01,420,1,16,165,0,585,THA
2019-01-01,3,0,0,0,0,3,TLS
2019-01-01,335,3,0,1,0,336,TTO
2019-01-01,14,16,1,1,0,15,TUN
2019-01-01,6,0,12,41,0,47,TUR
2019-01-01,7,7,1,0,2,7,TWN
2019-01-01,2,0,0,0,0,2,TZA
2019-01-01,14,5,3,6,0,20,UKR
2019-01-01,0,0,1,0,0,0,URY
2019-01-01,2285,46,1,558,5,2843,USA
2019-01-01,12,2,2,5,0,17,VEN
2019-01-01,1,0,0,0,0,1,VIR
2019-01-01,41,1,18,120,10,161,VNM
2019-01-01,0,0,1,0,0,0,VUT
2019-01-01,4,0,12,0,0,4,YEM
2019-01-01,1,0,3,1,0,2,ZAF
2019-02-01,1,0,0,0,0,1,ABW
2019-02-01,245,2,0,0,0,245,AGO
2019-02-01,0,1,0,0,0,0,ALB
2019-02-01,511,1,2,12,0,523,ARE
2019-02-01,0,0,1,0,0,0,ASM
2019-02-01,0,0,1,0,0,0,ATG
2019-02-01,64,2,32,61,0,125,AUS
2019-02-01,0,0,1,5,321,5,BEL
2019-02-01,7,0,0,0,0,7,BEN
2019-02-01,0,0,1,0,0,0,BES
2019-02-01,3,2,0,0,0,3,BGD
2019-02-01,1,0,0,0,0,1,BGR
2019-02-01,6,0,1,1,0,7,BHR
2019-02-01,0,0,4,4,0,4,BHS
2019-02-01,136,10,7,19,0,155,BRA
2019-02-01,129,3,0,0,0,129,BRN
2019-02-01,5,0,6,12,0,17,CAN
2019-02-01,0,0,2,0,0,0,CHL
2019-02-01,298,48,115,258,1424,556,CHN
2019-02-01,12,1,1,0,0,12,CIV
2019-02-01,76,0,0,0,0,76,CMR
2019-02-01,50,0,0,0,0,50,COD
2019-02-01,77,0,0,0,0,77,COG
2019-02-01,6,0,2,0,0,6,COL
2019-02-01,3,0,5,4,0,7,CUB
2019-02-01,22,18,2,32,1475,54,DEU
2019-02-01,2,0,1,0,0,2,DJI
2019-02-01,18,2,1,24,513,42,DNK
2019-02-01,0,0,1,0,0,0,DOM
2019-02-01,0,0,4,0,0,0,DZA
2019-02-01,11,1,4,0,0,11,ECU
2019-02-01,181,6,1,7,0,188,EGY
2019-02-01,0,0,4,0,0,0,ERI
2019-02-01,3,8,0,5,0,8,ESP
2019-02-01,0,0,0,1,0,1,EST
2019-02-01,0,0,0,47,6,47,FIN
2019-02-01,0,0,1,1,0,1,FJI
2019-02-01,0,0,2,26,0,26,FRA
2019-02-01,119,0,1,0,0,119,GAB
2019-02-01,176,10,3,16,2230,192,GBR
2019-02-01,1,0,0,0,0,1,GEO
2019-02-01,2,0,4,1,0,3,GHA
2019-02-01,0,0,3,1,0,1,GIN
2019-02-01,0,0,2,0,0,0,GMB
2019-02-01,0,0,1,5,0,5,GNB
2019-02-01,13,0,0,0,0,13,GNQ
2019-02-01,5,0,0,4,0,9,GRC
2019-02-01,0,0,1,0,0,0,GUF
2019-02-01,0,0,1,0,0,0,GUY
2019-02-01,16,0,0,3,0,19,HRV
2019-02-01,556,89,67,142,0,698,IDN
2019-02-01,181,3,34,18,0,199,IND
2019-02-01,3,0,1,3,7,6,IRL
2019-02-01,163,2,0,1,0,164,IRN
2019-02-01,1,0,0,8,0,9,IRQ
2019-02-01,0,0,0,2,0,2,ISL
2019-02-01,4,0,2,0,0,4,ISR
2019-02-01,102,8,3,5,0,107,ITA
2019-02-01,0,0,1,0,0,0,JAM
2019-02-01,0,0,0,1,0,1,JEY
2019-02-01,18,12,40,27,0,45,JPN
2019-02-01,0,0,3,0,0,0,KEN
2019-02-01,3,0,2,5,0,8,KHM
2019-02-01,6,0,53,57,12,63,KOR
2019-02-01,31,1,0,29,0,60,KWT
2019-02-01,0,0,1,0,0,0,LBN
2019-02-01,0,0,4,1,0,1,LBR
2019-02-01,11,0,1,0,0,11,LBY
2019-02-01,0,0,3,1,0,1,LKA
2019-02-01,1,0,0,0,0,1,LTU
2019-02-01,0,0,1,0,0,0,LVA
2019-02-01,0,0,1,0,0,0,MDG
2019-02-01,189,2,14,2,0,191,MEX
2019-02-01,4,5,17,10,0,14,MMR
2019-02-01,0,0,0,3,0,3,MOZ
2019-02-01,0,0,3,0,0,0,MRT
2019-02-01,331,60,63,55,0,386,MYS
2019-02-01,9,0,0,0,0,9,NAM
2019-02-01,0,0,0,1,0,1,NCL
2019-02-01,438,3,3,1,0,439,NGA
2019-02-01,0,0,2,2,0,2,NIC
2019-02-01,114,13,1,5,294,119,NLD
2019-02-01,18,0,0,7,1,25,NOR
2019-02-01,7,0,2,7,0,14,NZL
2019-02-01,16,0,10,3,0,19,None
2019-02-01,6,0,3,0,0,6,OMN
2019-02-01,0,0,2,0,0,0,PAK
2019-02-01,0,1,5,0,0,0,PAN
2019-02-01,94,1,7,0,0,94,PER
2019-02-01,7,0,11,38,0,45,PHL
2019-02-01,3,0,0,1,0,4,PNG
2019-02-01,9,3,0,5,3,14,POL
2019-02-01,1,0,3,3,0,4,PRK
2019-02-01,0,0,1,1,0,1,PRT
2019-02-01,163,0,2,3,0,166,QAT
2019-02-01,8,0,0,0,0,8,ROU
2019-02-01,9,3,4,4,0,13,RUS
2019-02-01,701,28,10,4,0,705,SAU
2019-02-01,3,0,0,0,0,3,SEN
2019-02-01,0,0,0,40,0,40,SGP
2019-02-01,0,0,1,0,0,0,SLB
2019-02-01,0,0,2,4,0,4,SLE
2019-02-01,0,0,1,1,0,1,SOM
2019-02-01,0,0,1,48,65,48,SWE
2019-02-01,3,0,0,0,0,3,TGO
2019-02-01,419,1,17,177,0,596,THA
2019-02-01,3,0,0,0,0,3,TLS
2019-02-01,333,3,0,1,0,334,TTO
2019-02-01,14,15,1,2,0,16,TUN
2019-02-01,6,0,14,43,0,49,TUR
2019-02-01,7,7,1,0,2,7,TWN
2019-02-01,2,0,0,0,0,2,TZA
2019-02-01,14,5,3,8,0,22,UKR
2019-02-01,0,0,1,0,0,0,URY
2019-02-01,2298,46,1,581,5,2879,USA
2019-02-01,16,3,2,5,0,21,VEN
2019-02-01,1,0,0,0,0,1,VIR
2019-02-01,43,0,18,122,13,165,VNM
2019-02-01,0,0,1,0,0,0,VUT
2019-02-01,3,0,12,0,0,3,YEM
2019-02-01,1,0,2,1,0,2,ZAF
2019-03-01,1,0,0,0,0,1,ABW
2019-03-01,246,2,0,0,0,246,AGO
2019-03-01,0,1,0,0,0,0,ALB
2019-03-01,512,1,2,12,0,524,ARE
2019-03-01,0,0,1,0,0,0,ASM
2019-03-01,0,0,1,0,0,0,ATG
2019-03-01,66,1,36,66,0,132,AUS
2019-03-01,0,0,1,5,321,5,BEL
2019-03-01,7,0,0,0,0,7,BEN
2019-03-01,0,0,1,0,0,0,BES
2019-03-01,2,2,0,0,0,2,BGD
2019-03-01,1,0,0,0,0,1,BGR
2019-03-01,7,0,1,1,0,8,BHR
2019-03-01,0,0,3,4,0,4,BHS
2019-03-01,0,0,1,0,0,0,BLZ
2019-03-01,137,11,7,23,0,160,BRA
2019-03-01,132,3,0,0,0,132,BRN
2019-03-01,5,0,6,15,0,20,CAN
2019-03-01,0,0,1,0,0,0,CHL
2019-03-01,298,51,122,260,1471,558,CHN
2019-03-01,11,1,1,0,0,11,CIV
2019-03-01,76,0,0,0,0,76,CMR
2019-03-01,51,0,0,0,0,51,COD
2019-03-01,75,0,0,0,0,75,COG
2019-03-01,6,0,2,0,0,6,COL
2019-03-01,3,0,5,4,0,7,CUB
2019-03-01,21,19,2,30,1488,51,DEU
2019-03-01,0,0,1,0,0,0,DJI
2019-03-01,18,2,1,22,512,40,DNK
2019-03-01,0,0,2,0,0,0,DOM
2019-03-01,0,0,4,0,0,0,DZA
2019-03-01,11,1,5,0,0,11,ECU
2019-03-01,177,5,1,6,0,183,EGY
2019-03-01,0,0,4,0,0,0,ERI
2019-03-01,3,8,0,5,0,8,ESP
2019-03-01,0,0,0,1,0,1,EST
2019-03-01,0,0,0,49,6,49,FIN
2019-03-01,0,0,1,1,0,1,FJI
2019-03-01,0,0,2,25,0,25,FRA
2019-03-01,117,0,1,0,0,117,GAB
2019-03-01,174,12,3,16,2240,190,GBR
2019-03-01,1,0,0,0,0,1,GEO
2019-03-01,3,0,5,1,0,4,GHA
2019-03-01,0,0,3,1,0,1,GIN
2019-03-01,0,0,1,0,0,0,GMB
2019-03-01,0,0,1,7,0,7,GNB
2019-03-01,13,0,0,0,0,13,GNQ
2019-03-01,4,0,0,5,0,9,GRC
2019-03-01,0,0,1,0,0,0,GUF
2019-03-01,0,0,1,0,0,0,GUY
2019-03-01,16,0,0,3,0,19,HRV
2019-03-01,564,91,68,140,0,704,IDN
2019-03-01,186,4,34,16,0,202,IND
2019-03-01,3,0,1,3,7,6,IRL
2019-03-01,163,2,0,2,0,165,IRN
2019-03-01,1,0,0,4,0,5,IRQ
2019-03-01,0,0,0,2,0,2,ISL
2019-03-01,4,0,2,0,0,4,ISR
2019-03-01,103,8,3,5,0,108,ITA
2019-03-01,0,0,1,0,0,0,JAM
2019-03-01,0,0,0,1,0,1,JEY
2019-03-01,18,9,40,31,0,49,JPN
2019-03-01,0,0,3,0,0,0,KEN
2019-03-01,4,0,2,5,0,9,KHM
2019-03-01,6,0,53,59,12,65,KOR
2019-03-01,32,1,0,31,0,63,KWT
2019-03-01,0,0,1,0,0,0,LBN
2019-03-01,0,0,4,1,0,1,LBR
2019-03-01,11,0,1,0,0,11,LBY
2019-03-01,0,0,3,1,0,1,LKA
2019-03-01,1,0,0,0,0,1,LTU
2019-03-01,0,0,1,1,0,1,LVA
2019-03-01,0,0,1,0,0,0,MDG
2019-03-01,194,2,13,1,0,195,MEX
2019-03-01,4,4,17,11,0,15,MMR
2019-03-01,0,0,0,4,0,4,MOZ
2019-03-01,0,0,3,0,0,0,MRT
2019-03-01,330,67,67,54,0,384,MYS
2019-03-01,9,0,0,0,0,9,NAM
2019-03-01,0,0,0,1,0,1,NCL
2019-03-01,442,3,3,1,0,443,NGA
2019-03-01,0,0,2,2,0,2,NIC
2019-03-01,113,12,1,5,294,118,NLD
2019-03-01,16,0,0,7,1,23,NOR
2019-03-01,7,0,1,7,0,14,NZL
2019-03-01,17,0,10,2,0,19,None
2019-03-01,6,0,3,1,0,7,OMN
2019-03-01,0,0,2,0,0,0,PAK
2019-03-01,0,1,5,0,0,0,PAN
2019-03-01,95,1,5,0,0,95,PER
2019-03-01,7,0,10,38,0,45,PHL
2019-03-01,3,0,0,1,0,4,PNG
2019-03-01,9,3,0,5,3,14,POL
2019-03-01,1,0,3,3,0,4,PRK
2019-03-01,0,0,1,0,0,0,PRT
2019-03-01,166,0,3,3,0,169,QAT
2019-03-01,8,0,0,0,0,8,ROU
2019-03-01,9,3,4,3,0,12,RUS
2019-03-01,709,26,10,3,0,712,SAU
2019-03-01,1,1,3,0,0,1,SDN
2019-03-01,3,0,0,0,0,3,SEN
2019-03-01,0,0,0,47,0,47,SGP
2019-03-01,0,0,1,0,0,0,SLB
2019-03-01,0,0,2,5,0,5,SLE
2019-03-01,0,0,1,1,0,1,SOM
2019-03-01,0,0,1,50,65,50,SWE
2019-03-01,2,0,0,0,0,2,TGO
2019-03-01,419,1,18,174,0,593,THA
2019-03-01,4,0,0,0,0,4,TLS
2019-03-01,332,3,0,1,0,333,TTO
2019-03-01,14,15,1,2,0,16,TUN
2019-03-01,6,0,14,43,0,49,TUR
2019-03-01,7,7,1,0,2,7,TWN
2019-03-01,2,0,0,0,0,2,TZA
2019-03-01,14,5,3,9,0,23,UKR
2019-03-01,0,0,1,0,0,0,URY
2019-03-01,2284,47,2,584,5,2868,USA
2019-03-01,14,3,3,4,0,18,VEN
2019-03-01,1,0,0,0,0,1,VIR
2019-03-01,42,0,18,123,13,165,VNM
2019-03-01,0,0,1,0,0,0,VUT
2019-03-01,2,0,12,0,0,2,YEM
2019-03-01,1,0,2,1,0,2,ZAF
2019-04-01,1,0,0,0,0,1,ABW
2019-04-01,243,2,0,0,0,243,AGO
2019-04-01,514,2,2,13,0,527,ARE
2019-04-01,0,0,1,0,0,0,ASM
2019-04-01,0,0,1,0,0,0,ATG
2019-04-01,62,2,33,65,0,127,AUS
2019-04-01,0,0,1,5,321,5,BEL
2019-04-01,7,0,0,0,0,7,BEN
2019-04-01,0,0,1,0,0,0,BES
2019-04-01,2,1,0,0,0,2,BGD
2019-04-01,1,0,1,0,0,1,BGR
2019-04-01,7,0,1,1,0,8,BHR
2019-04-01,0,0,3,4,0,4,BHS
2019-04-01,0,0,1,0,0,0,BLZ
2019-04-01,136,11,7,21,0,157,BRA
2019-04-01,131,3,0,0,0,131,BRN
2019-04-01,5,0,6,17,0,22,CAN
2019-04-01,299,55,127,269,1529,568,CHN
2019-04-01,11,1,1,0,0,11,CIV
2019-04-01,76,0,0,0,0,76,CMR
2019-04-01,51,0,0,0,0,51,COD
2019-04-01,73,0,0,0,0,73,COG
2019-04-01,6,0,1,0,0,6,COL
2019-04-01,3,0,5,3,0,6,CUB
2019-04-01,0,0,1,0,0,0,CYP
2019-04-01,20,18,2,28,1489,48,DEU
2019-04-01,0,0,1,0,0,0,DJI
2019-04-01,19,2,1,20,512,39,DNK
2019-04-01,0,0,2,0,0,0,DOM
2019-04-01,0,0,4,0,0,0,DZA
2019-04-01,11,1,5,0,0,11,ECU
2019-04-01,179,4,0,6,0,185,EGY
2019-04-01,0,0,4,0,0,0,ERI
2019-04-01,3,9,0,5,0,8,ESP
2019-04-01,0,0,0,1,0,1,EST
2019-04-01,0,0,0,53,5,53,FIN
2019-04-01,0,0,1,1,0,1,FJI
2019-04-01,0,0,4,26,0,26,FRA
2019-04-01,118,0,1,0,0,118,GAB
2019-04-01,177,12,3,18,2243,195,GBR
2019-04-01,1,0,0,0,0,1,GEO
2019-04-01,4,0,5,1,0,5,GHA
2019-04-01,0,0,3,1,0,1,GIN
2019-04-01,0,0,1,0,0,0,GMB
2019-04-01,0,0,1,7,0,7,GNB
2019-04-01,13,0,0,0,0,13,GNQ
2019-04-01,4,0,0,5,0,9,GRC
2019-04-01,0,0,1,0,0,0,GUF
2019-04-01,16,0,0,3,0,19,HRV
2019-04-01,557,105,67,130,0,687,IDN
2019-04-01,180,5,32,15,0,195,IND
2019-04-01,3,0,1,3,7,6,IRL
2019-04-01,163,2,0,2,0,165,IRN
2019-04-01,1,0,0,3,0,4,IRQ
2019-04-01,0,0,0,2,0,2,ISL
2019-04-01,5,0,2,0,0,5,ISR
2019-04-01,103,7,3,4,0,107,ITA
2019-04-01,0,0,1,0,0,0,JAM
2019-04-01,0,0,0,5,0,5,JEY
2019-04-01,18,9,41,32,0,50,JPN
2019-04-01,0,0,3,0,0,0,KEN
2019-04-01,4,0,2,3,0,7,KHM
2019-04-01,6,0,58,58,13,64,KOR
2019-04-01,33,1,0,25,0,58,KWT
2019-04-01,0,0,1,0,0,0,LBN
2019-04-01,0,0,4,1,0,1,LBR
2019-04-01,11,0,1,0,0,11,LBY
2019-04-01,0,0,3,1,0,1,LKA
2019-04-01,1,0,0,0,0,1,LTU
2019-04-01,0,0,1,2,0,2,LVA
2019-04-01,0,0,1,0,0,0,MDG
2019-04-01,192,3,12,1,0,193,MEX
2019-04-01,4,4,17,12,0,16,MMR
2019-04-01,0,0,1,4,0,4,MOZ
2019-04-01,0,0,3,1,0,1,MRT
2019-04-01,329,64,57,56,0,385,MYS
2019-04-01,9,0,0,0,0,9,NAM
2019-04-01,0,0,0,1,0,1,NCL
2019-04-01,439,3,2,1,0,440,NGA
2019-04-01,0,0,2,1,0,1,NIC
2019-04-01,114,12,1,5,295,119,NLD
2019-04-01,18,0,0,7,1,25,NOR
2019-04-01,7,0,1,7,0,14,NZL
2019-04-01,18,0,10,2,0,20,None
2019-04-01,6,0,3,1,0,7,OMN
2019-04-01,0,0,2,0,0,0,PAK
2019-04-01,0,1,5,0,0,0,PAN
2019-04-01,96,1,5,0,0,96,PER
2019-04-01,7,0,10,39,0,46,PHL
2019-04-01,3,0,0,1,0,4,PNG
2019-04-01,9,3,0,5,3,14,POL
2019-04-01,1,0,3,3,0,4,PRK
2019-04-01,0,0,1,0,0,0,PRT
2019-04-01,168,0,4,2,0,170,QAT
2019-04-01,8,0,0,0,0,8,ROU
2019-04-01,10,2,5,3,0,13,RUS
2019-04-01,713,24,9,3,0,716,SAU
2019-04-01,1,1,3,0,0,1,SDN
2019-04-01,2,0,0,0,0,2,SEN
2019-04-01,0,0,0,46,0,46,SGP
2019-04-01,0,0,1,0,0,0,SLB
2019-04-01,0,0,2,5,0,5,SLE
2019-04-01,0,0,1,2,0,2,SOM
2019-04-01,0,0,1,49,65,49,SWE
2019-04-01,2,0,0,0,0,2,TGO
2019-04-01,418,1,20,162,0,580,THA
2019-04-01,4,0,0,0,0,4,TLS
2019-04-01,327,3,0,1,0,328,TTO
2019-04-01,14,14,1,1,0,15,TUN
2019-04-01,6,0,14,42,0,48,TUR
2019-04-01,7,7,1,0,2,7,TWN
2019-04-01,2,0,0,0,0,2,TZA
2019-04-01,14,5,3,9,0,23,UKR
2019-04-01,0,0,1,0,0,0,URY
2019-04-01,2281,45,3,587,5,2868,USA
2019-04-01,17,3,3,3,0,20,VEN
2019-04-01,1,0,0,0,0,1,VIR
2019-04-01,43,0,16,131,13,174,VNM
2019-04-01,0,0,1,0,0,0,VUT
2019-04-01,2,0,11,0,0,2,YEM
2019-04-01,1,0,2,1,0,2,ZAF
2019-05-01,1,0,0,0,0,1,ABW
2019-05-01,247,2,0,0,0,247,AGO
2019-05-01,515,2,2,13,0,528,ARE
2019-05-01,0,0,1,0,0,0,ASM
2019-05-01,0,0,1,0,0,0,ATG
2019-05-01,63,2,33,65,0,128,AUS
2019-05-01,0,0,1,5,321,5,BEL
2019-05-01,7,0,0,0,0,7,BEN
2019-05-01,0,0,1,0,0,0,BES
2019-05-01,2,1,1,0,0,2,BGD
2019-05-01,1,0,1,0,0,1,BGR
2019-05-01,7,0,1,1,0,8,BHR
2019-05-01,0,0,3,4,0,4,BHS
2019-05-01,0,0,1,0,0,0,BLZ
2019-05-01,135,10,7,22,0,157,BRA
2019-05-01,131,3,0,0,0,131,BRN
2019-05-01,5,0,11,21,0,26,CAN
2019-05-01,302,56,129,275,1589,577,CHN
2019-05-01,11,1,1,0,0,11,CIV
2019-05-01,74,0,0,0,0,74,CMR
2019-05-01,51,0,0,0,0,51,COD
2019-05-01,76,0,0,0,0,76,COG
2019-05-01,6,0,1,0,0,6,COL
2019-05-01,3,0,6,3,0,6,CUB
2019-05-01,1,0,1,0,0,1,CYP
2019-05-01,21,19,2,29,1499,50,DEU
2019-05-01,0,0,1,0,0,0,DJI
2019-05-01,18,2,1,23,513,41,DNK
2019-05-01,0,0,2,0,0,0,DOM
2019-05-01,0,0,4,0,0,0,DZA
2019-05-01,11,1,4,0,0,11,ECU
2019-05-01,182,5,0,5,0,187,EGY
2019-05-01,0,0,2,0,0,0,ERI
2019-05-01,3,9,0,6,0,9,ESP
2019-05-01,0,0,0,1,0,1,EST
2019-05-01,0,0,0,58,5,58,FIN
2019-05-01,0,0,0,1,0,1,FJI
2019-05-01,0,0,6,28,0,28,FRA
2019-05-01,117,0,1,0,0,117,GAB
2019-05-01,176,13,4,17,2245,193,GBR
2019-05-01,1,0,0,0,0,1,GEO
2019-05-01,3,0,4,1,0,4,GHA
2019-05-01,0,0,2,1,0,1,GIN
2019-05-01,0,0,1,6,0,6,GNB
2019-05-01,13,0,0,0,0,13,GNQ
2019-05-01,6,0,0,3,0,9,GRC
2019-05-01,0,0,1,0,0,0,GUF
2019-05-01,16,0,0,3,0,19,HRV
2019-05-01,559,92,67,119,0,678,IDN
2019-05-01,181,3,30,16,0,197,IND
2019-05-01,3,0,1,3,7,6,IRL
2019-05-01,166,2,0,2,0,168,IRN
2019-05-01,1,0,0,3,0,4,IRQ
2019-05-01,0,0,0,2,0,2,ISL
2019-05-01,5,0,3,0,0,5,ISR
2019-05-01,103,7,3,4,0,107,ITA
2019-05-01,0,0,1,0,0,0,JAM
2019-05-01,0,0,0,5,0,5,JEY
2019-05-01,18,9,41,30,0,48,JPN
2019-05-01,0,0,3,0,0,0,KEN
2019-05-01,4,0,2,3,0,7,KHM
2019-05-01,6,0,58,57,13,63,KOR
2019-05-01,33,1,0,24,0,57,KWT
2019-05-01,0,0,1,0,0,0,LBN
2019-05-01,0,0,3,1,0,1,LBR
2019-05-01,10,0,1,1,0,11,LBY
2019-05-01,0,0,4,3,0,3,LKA
2019-05-01,1,0,0,0,0,1,LTU
2019-05-01,0,0,1,2,0,2,LVA
2019-05-01,0,0,1,0,0,0,MDG
2019-05-01,187,3,11,1,0,188,MEX
2019-05-01,4,2,13,12,0,16,MMR
2019-05-01,0,0,1,4,0,4,MOZ
2019-05-01,0,0,3,1,0,1,MRT
2019-05-01,323,47,51,52,0,375,MYS
2019-05-01,9,0,0,0,0,9,NAM
2019-05-01,0,0,0,1,0,1,NCL
2019-05-01,440,4,2,1,0,441,NGA
2019-05-01,0,0,2,1,0,1,NIC
2019-05-01,113,13,1,4,295,117,NLD
2019-05-01,19,0,0,6,1,25,NOR
2019-05-01,7,0,1,6,0,13,NZL
2019-05-01,18,0,12,3,0,21,None
2019-05-01,6,0,3,1,0,7,OMN
2019-05-01,0,0,2,0,0,0,PAK
2019-05-01,0,0,4,0,0,0,PAN
2019-05-01,98,1,3,0,0,98,PER
2019-05-01,7,0,13,32,0,39,PHL
2019-05-01,2,0,0,1,0,3,PNG
2019-05-01,9,3,0,5,3,14,POL
2019-05-01,1,0,3,5,0,6,PRK
2019-05-01,0,0,1,0,0,0,PRT
2019-05-01,169,0,4,2,0,171,QAT
2019-05-01,8,0,0,0,0,8,ROU
2019-05-01,9,3,5,4,0,13,RUS
2019-05-01,715,24,8,2,0,717,SAU
2019-05-01,1,1,3,0,0,1,SDN
2019-05-01,1,0,1,0,0,1,SEN
2019-05-01,0,0,0,43,0,43,SGP
2019-05-01,0,0,1,0,0,0,SLB
2019-05-01,0,0,2,5,0,5,SLE
2019-05-01,0,0,1,2,0,2,SOM
2019-05-01,0,0,1,46,65,46,SWE
2019-05-01,2,0,0,0,0,2,TGO
2019-05-01,418,1,19,166,0,584,THA
2019-05-01,3,0,0,0,0,3,TLS
2019-05-01,326,3,0,1,0,327,TTO
2019-05-01,14,14,1,0,0,14,TUN
2019-05-01,6,0,14,45,0,51,TUR
2019-05-01,7,7,1,0,2,7,TWN
2019-05-01,2,0,0,0,0,2,TZA
2019-05-01,13,5,3,8,0,21,UKR
2019-05-01,0,0,1,0,0,0,URY
2019-05-01,2270,47,3,608,5,2878,USA
2019-05-01,17,3,3,5,0,22,VEN
2019-05-01,1,0,0,0,0,1,VIR
2019-05-01,43,0,17,138,13,181,VNM
2019-05-01,0,0,1,0,0,0,VUT
2019-05-01,1,0,10,0,0,1,YEM
2019-05-01,1,0,3,1,0,2,ZAF
2019-06-01,1,0,0,0,0,1,ABW
2019-06-01,242,2,0,0,0,242,AGO
2019-06-01,513,2,2,12,0,525,ARE
2019-06-01,0,0,1,0,0,0,ASM
2019-06-01,0,0,1,0,0,0,ATG
2019-06-01,65,3,29,61,0,126,AUS
2019-06-01,0,0,1,5,321,5,BEL
2019-06-01,7,0,0,0,0,7,BEN
2019-06-01,0,0,1,0,0,0,BES
2019-06-01,2,1,1,0,0,2,BGD
2019-06-01,1,0,1,0,0,1,BGR
2019-06-01,7,0,1,1,0,8,BHR
2019-06-01,0,0,3,4,0,4,BHS
2019-06-01,0,0,1,0,0,0,BLZ
2019-06-01,140,10,7,22,0,162,BRA
2019-06-01,130,3,0,0,0,130,BRN
2019-06-01,5,0,11,24,0,29,CAN
2019-06-01,299,61,128,288,1647,587,CHN
2019-06-01,11,1,1,0,0,11,CIV
2019-06-01,73,0,0,0,0,73,CMR
2019-06-01,51,0,0,0,0,51,COD
2019-06-01,76,0,0,0,0,76,COG
2019-06-01,5,0,2,0,0,5,COL
2019-06-01,3,0,6,3,0,6,CUB
2019-06-01,1,0,1,0,0,1,CYP
2019-06-01,21,19,2,30,1501,51,DEU
2019-06-01,0,0,1,0,0,0,DJI
2019-06-01,18,2,1,24,513,42,DNK
2019-06-01,0,0,2,0,0,0,DOM
2019-06-01,0,0,4,0,0,0,DZA
2019-06-01,11,1,4,0,0,11,ECU
2019-06-01,184,5,0,5,0,189,EGY
2019-06-01,0,0,2,0,0,0,ERI
2019-06-01,3,7,0,7,0,10,ESP
2019-06-01,0,0,0,1,0,1,EST
2019-06-01,0,0,1,59,5,59,FIN
2019-06-01,0,0,7,28,0,28,FRA
2019-06-01,116,0,1,0,0,116,GAB
2019-06-01,175,13,3,16,2293,191,GBR
2019-06-01,1,0,0,0,0,1,GEO
2019-06-01,2,0,4,1,0,3,GHA
2019-06-01,0,0,2,1,0,1,GIN
2019-06-01,0,0,1,5,0,5,GNB
2019-06-01,13,0,0,0,0,13,GNQ
2019-06-01,6,0,0,3,0,9,GRC
2019-06-01,0,0,1,0,0,0,GUF
2019-06-01,16,0,0,3,0,19,HRV
2019-06-01,567,87,69,120,0,687,IDN
2019-06-01,182,3,30,18,0,200,IND
2019-06-01,3,0,1,3,7,6,IRL
2019-06-01,166,2,0,2,0,168,IRN
2019-06-01,1,0,0,3,0,4,IRQ
2019-06-01,0,0,0,2,0,2,ISL
2019-06-01,5,0,3,0,0,5,ISR
2019-06-01,103,7,3,4,0,107,ITA
2019-06-01,0,0,1,0,0,0,JAM
2019-06-01,0,0,0,3,0,3,JEY
2019-06-01,18,9,46,33,0,51,JPN
2019-06-01,0,0,3,0,0,0,KEN
2019-06-01,3,0,1,3,0,6,KHM
2019-06-01,6,0,58,51,13,57,KOR
2019-06-01,34,2,0,35,0,69,KWT
2019-06-01,0,0,1,0,0,0,LBN
2019-06-01,0,0,3,1,0,1,LBR
2019-06-01,11,0,1,1,0,12,LBY
2019-06-01,0,0,4,3,0,3,LKA
2019-06-01,1,0,0,0,0,1,LTU
2019-06-01,0,0,1,2,0,2,LVA
2019-06-01,0,0,1,0,0,0,MDG
2019-06-01,195,4,12,2,0,197,MEX
2019-06-01,4,1,13,11,0,15,MMR
2019-06-01,0,0,1,4,0,4,MOZ
2019-06-01,0,0,2,1,0,1,MRT
2019-06-01,318,40,46,49,0,367,MYS
2019-06-01,11,0,0,0,0,11,NAM
2019-06-01,0,0,0,1,0,1,NCL
2019-06-01,434,4,3,1,0,435,NGA
2019-06-01,0,0,2,1,0,1,NIC
2019-06-01,107,13,1,5,294,112,NLD
2019-06-01,18,0,0,7,1,25,NOR
2019-06-01,7,0,1,6,0,13,NZL
2019-06-01,17,0,12,3,0,20,None
2019-06-01,6,0,3,0,0,6,OMN
2019-06-01,0,0,2,0,0,0,PAK
2019-06-01,0,0,4,0,0,0,PAN
2019-06-01,98,2,3,0,0,98,PER
2019-06-01,7,0,16,38,0,45,PHL
2019-06-01,2,0,0,1,0,3,PNG
2019-06-01,9,3,0,5,3,14,POL
2019-06-01,1,0,3,5,0,6,PRK
2019-06-01,0,0,1,0,0,0,PRT
2019-06-01,164,0,4,2,0,166,QAT
2019-06-01,8,0,0,0,0,8,ROU
2019-06-01,9,3,5,4,0,13,RUS
2019-06-01,717,25,9,2,0,719,SAU
2019-06-01,1,1,3,0,0,1,SDN
2019-06-01,1,0,1,0,0,1,SEN
2019-06-01,0,0,0,40,0,40,SGP
2019-06-01,0,0,1,0,0,0,SLB
2019-06-01,0,0,2,5,0,5,SLE
2019-06-01,0,0,1,2,0,2,SOM
2019-06-01,0,0,1,48,65,48,SWE
2019-06-01,2,0,0,0,0,2,TGO
2019-06-01,418,1,20,162,0,580,THA
2019-06-01,3,0,0,0,0,3,TLS
2019-06-01,332,3,0,1,0,333,TTO
2019-06-01,14,15,1,0,0,14,TUN
2019-06-01,6,0,13,47,0,53,TUR
2019-06-01,7,7,1,0,10,7,TWN
2019-06-01,2,0,0,0,0,2,TZA
2019-06-01,13,5,3,8,0,21,UKR
2019-06-01,0,0,1,0,0,0,URY
2019-06-01,2263,47,3,606,5,2869,USA
2019-06-01,15,3,2,6,0,21,VEN
2019-06-01,1,0,0,0,0,1,VIR
2019-06-01,43,1,18,148,12,191,VNM
2019-06-01,0,0,1,0,0,0,VUT
2019-06-01,1,0,9,0,0,1,YEM
2019-06-01,1,0,3,1,0,2,ZAF
2019-07-01,1,0,0,0,0,1,ABW
2019-07-01,243,2,0,0,0,243,AGO
2019-07-01,518,2,2,12,0,530,ARE
2019-07-01,0,0,1,0,0,0,ASM
2019-07-01,0,0,1,0,0,0,ATG
2019-07-01,65,4,27,56,0,121,AUS
2019-07-01,0,0,1,5,321,5,BEL
2019-07-01,7,0,0,0,0,7,BEN
2019-07-01,0,0,1,0,0,0,BES
2019-07-01,2,1,1,0,0,2,BGD
2019-07-01,1,0,1,0,0,1,BGR
2019-07-01,5,0,1,1,0,6,BHR
2019-07-01,0,0,3,4,0,4,BHS
2019-07-01,0,0,1,0,0,0,BLZ
2019-07-01,141,11,8,24,0,165,BRA
2019-07-01,131,3,0,0,0,131,BRN
2019-07-01,5,0,8,27,0,32,CAN
2019-07-01,302,66,124,267,1696,569,CHN
2019-07-01,11,1,1,0,0,11,CIV
2019-07-01,74,0,0,0,0,74,CMR
2019-07-01,50,0,0,0,0,50,COD
2019-07-01,75,0,0,0,0,75,COG
2019-07-01,5,0,2,0,0,5,COL
2019-07-01,3,0,6,3,0,6,CUB
2019-07-01,1,0,1,0,0,1,CYP
2019-07-01,21,19,2,30,1502,51,DEU
2019-07-01,0,0,1,0,0,0,DJI
2019-07-01,18,2,1,23,513,41,DNK
2019-07-01,0,0,2,0,0,0,DOM
2019-07-01,0,0,4,0,0,0,DZA
2019-07-01,11,1,3,0,0,11,ECU
2019-07-01,183,6,0,6,0,189,EGY
2019-07-01,0,0,2,1,0,1,ERI
2019-07-01,3,7,0,7,0,10,ESP
2019-07-01,0,0,0,1,0,1,EST
2019-07-01,0,0,1,59,5,59,FIN
2019-07-01,0,0,7,29,0,29,FRA
2019-07-01,116,0,1,0,0,116,GAB
2019-07-01,176,16,4,18,2309,194,GBR
2019-07-01,1,0,0,0,0,1,GEO
2019-07-01,2,0,4,1,0,3,GHA
2019-07-01,0,0,2,2,0,2,GIN
2019-07-01,0,0,1,8,0,8,GNB
2019-07-01,13,0,0,0,0,13,GNQ
2019-07-01,6,0,0,4,0,10,GRC
2019-07-01,0,0,1,0,0,0,GUF
2019-07-01,16,0,0,3,0,19,HRV
2019-07-01,562,77,71,120,0,682,IDN
2019-07-01,182,3,30,16,0,198,IND
2019-07-01,3,0,1,3,7,6,IRL
2019-07-01,168,2,0,2,0,170,IRN
2019-07-01,1,0,0,3,0,4,IRQ
2019-07-01,0,0,0,2,0,2,ISL
2019-07-01,4,0,3,0,0,4,ISR
2019-07-01,103,6,3,5,0,108,ITA
2019-07-01,0,0,1,0,0,0,JAM
2019-07-01,0,0,0,1,0,1,JEY
2019-07-01,18,9,47,38,0,56,JPN
2019-07-01,0,0,3,0,0,0,KEN
2019-07-01,3,0,1,2,0,5,KHM
2019-07-01,6,0,57,43,13,49,KOR
2019-07-01,34,2,0,37,0,71,KWT
2019-07-01,0,0,1,0,0,0,LBN
2019-07-01,0,0,3,1,0,1,LBR
2019-07-01,11,0,1,1,0,12,LBY
2019-07-01,0,0,4,3,0,3,LKA
2019-07-01,1,0,0,0,0,1,LTU
2019-07-01,0,0,1,1,0,1,LVA
2019-07-01,0,0,1,0,0,0,MDG
2019-07-01,194,5,13,2,0,196,MEX
2019-07-01,5,1,14,10,0,15,MMR
2019-07-01,0,0,1,4,0,4,MOZ
2019-07-01,0,0,1,0,0,0,MRT
2019-07-01,324,26,53,47,0,371,MYS
2019-07-01,10,0,0,0,0,10,NAM
2019-07-01,433,4,3,1,0,434,NGA
2019-07-01,0,0,2,1,0,1,NIC
2019-07-01,107,13,1,7,294,114,NLD
2019-07-01,17,0,0,8,1,25,NOR
2019-07-01,7,0,1,6,0,13,NZL
2019-07-01,14,0,10,3,0,17,None
2019-07-01,6,0,4,1,0,7,OMN
2019-07-01,0,0,2,0,0,0,PAK
2019-07-01,0,0,4,0,0,0,PAN
2019-07-01,99,2,4,1,0,100,PER
2019-07-01,7,0,15,42,0,49,PHL
2019-07-01,2,0,1,1,0,3,PNG
2019-07-01,9,3,0,5,3,14,POL
2019-07-01,1,0,3,5,0,6,PRK
2019-07-01,0,0,1,0,0,0,PRT
2019-07-01,165,0,4,2,0,167,QAT
2019-07-01,8,1,0,0,0,8,ROU
2019-07-01,8,2,6,6,0,14,RUS
2019-07-01,718,26,9,2,0,720,SAU
2019-07-01,1,1,3,0,0,1,SDN
2019-07-01,1,0,1,0,0,1,SEN
2019-07-01,0,0,0,36,0,36,SGP
2019-07-01,0,0,1,0,0,0,SLB
2019-07-01,0,0,2,5,0,5,SLE
2019-07-01,0,0,1,1,0,1,SOM
2019-07-01,0,0,1,48,65,48,SWE
2019-07-01,2,0,0,0,0,2,TGO
2019-07-01,418,1,18,149,0,567,THA
2019-07-01,3,0,0,0,0,3,TLS
2019-07-01,338,3,0,1,0,339,TTO
2019-07-01,14,15,1,1,0,15,TUN
2019-07-01,6,0,13,46,0,52,TUR
2019-07-01,7,7,1,0,10,7,TWN
2019-07-01,2,0,0,0,0,2,TZA
2019-07-01,13,5,3,8,0,21,UKR
2019-07-01,0,0,1,0,0,0,URY
2019-07-01,2258,46,3,601,5,2859,USA
2019-07-01,11,3,2,6,0,17,VEN
2019-07-01,1,0,0,0,0,1,VIR
2019-07-01,44,1,18,169,13,213,VNM
2019-07-01,0,0,1,0,0,0,VUT
2019-07-01,2,0,9,0,0,2,YEM
2019-07-01,1,0,3,1,0,2,ZAF
2019-08-01,1,0,0,0,0,1,ABW
2019-08-01,246,3,0,0,0,246,AGO
2019-08-01,520,1,3,13,0,533,ARE
2019-08-01,0,0,1,0,0,0,ASM
2019-08-01,0,0,1,0,0,0,ATG
2019-08-01,63,4,23,47,0,110,AUS
2019-08-01,0,0,1,5,321,5,BEL
2019-08-01,6,0,0,0,0,6,BEN
2019-08-01,0,0,1,0,0,0,BES
2019-08-01,2,1,1,0,0,2,BGD
2019-08-01,1,0,0,0,0,1,BGR
2019-08-01,5,0,1,1,0,6,BHR
2019-08-01,0,0,2,4,0,4,BHS
2019-08-01,0,0,1,0,0,0,BLZ
2019-08-01,140,11,8,23,0,163,BRA
2019-08-01,130,3,0,0,0,130,BRN
2019-08-01,6,0,9,28,0,34,CAN
2019-08-01,304,65,124,258,1734,562,CHN
2019-08-01,11,1,1,0,0,11,CIV
2019-08-01,74,0,0,0,0,74,CMR
2019-08-01,48,0,0,0,0,48,COD
2019-08-01,75,0,0,0,0,75,COG
2019-08-01,5,0,1,0,0,5,COL
2019-08-01,3,0,4,2,0,5,CUB
2019-08-01,0,0,1,0,0,0,CYP
2019-08-01,21,19,2,30,1502,51,DEU
2019-08-01,0,0,1,0,0,0,DJI
2019-08-01,16,2,1,21,513,37,DNK
2019-08-01,0,0,1,0,0,0,DOM
2019-08-01,0,0,4,0,0,0,DZA
2019-08-01,12,2,2,0,0,12,ECU
2019-08-01,184,7,0,7,0,191,EGY
2019-08-01,0,0,2,1,0,1,ERI
2019-08-01,3,8,0,7,0,10,ESP
2019-08-01,0,0,0,1,0,1,EST
2019-08-01,0,0,1,59,5,59,FIN
2019-08-01,0,0,0,1,0,1,FJI
2019-08-01,0,0,6,26,0,26,FRA
2019-08-01,116,0,1,0,0,116,GAB
2019-08-01,176,16,3,17,2308,193,GBR
2019-08-01,1,0,0,0,0,1,GEO
2019-08-01,2,0,6,1,0,3,GHA
2019-08-01,0,0,2,2,0,2,GIN
2019-08-01,0,0,1,7,0,7,GNB
2019-08-01,14,0,0,0,0,14,GNQ
2019-08-01,6,0,0,4,0,10,GRC
2019-08-01,0,0,1,0,0,0,GUF
2019-08-01,16,0,0,3,0,19,HRV
2019-08-01,563,62,73,132,0,695,IDN
2019-08-01,181,2,31,12,0,193,IND
2019-08-01,3,0,2,3,7,6,IRL
2019-08-01,167,2,0,2,0,169,IRN
2019-08-01,1,0,1,8,0,9,IRQ
2019-08-01,0,0,1,3,0,3,ISL
2019-08-01,4,0,3,0,0,4,ISR
2019-08-01,103,6,3,5,0,108,ITA
2019-08-01,0,0,1,1,0,1,JAM
2019-08-01,0,0,0,1,0,1,JEY
2019-08-01,17,10,47,39,0,56,JPN
2019-08-01,0,0,3,0,0,0,KEN
2019-08-01,3,0,1,2,0,5,KHM
2019-08-01,7,0,57,40,13,47,KOR
2019-08-01,33,2,0,31,0,64,KWT
2019-08-01,0,0,1,0,0,0,LBN
2019-08-01,0,0,4,1,0,1,LBR
2019-08-01,11,0,1,1,0,12,LBY
2019-08-01,0,0,4,4,0,4,LKA
2019-08-01,1,0,0,0,0,1,LTU
2019-08-01,0,0,1,1,0,1,LVA
2019-08-01,0,0,1,0,0,0,MDG
2019-08-01,192,4,12,2,0,194,MEX
2019-08-01,5,3,14,9,0,14,MMR
2019-08-01,0,0,1,4,0,4,MOZ
2019-08-01,0,0,1,0,0,0,MRT
2019-08-01,322,24,51,50,0,372,MYS
2019-08-01,8,0,0,0,0,8,NAM
2019-08-01,432,4,4,1,0,433,NGA
2019-08-01,0,0,2,1,0,1,NIC
2019-08-01,111,12,1,7,293,118,NLD
2019-08-01,16,0,0,8,2,24,NOR
2019-08-01,7,0,1,5,0,12,NZL
2019-08-01,14,0,11,3,0,17,None
2019-08-01,6,0,4,1,0,7,OMN
2019-08-01,0,0,2,0,0,0,PAK
2019-08-01,0,0,4,0,0,0,PAN
2019-08-01,94,1,3,1,0,95,PER
2019-08-01,7,0,14,41,0,48,PHL
2019-08-01,2,0,1,1,0,3,PNG
2019-08-01,9,3,0,5,3,14,POL
2019-08-01,1,0,4,4,0,5,PRK
2019-08-01,0,0,1,0,0,0,PRT
2019-08-01,170,0,4,2,0,172,QAT
2019-08-01,8,1,0,0,0,8,ROU
2019-08-01,9,2,9,8,0,17,RUS
2019-08-01,717,28,7,2,0,719,SAU
2019-08-01,1,1,3,0,0,1,SDN
2019-08-01,0,0,1,0,0,0,SEN
2019-08-01,0,0,0,45,0,45,SGP
2019-08-01,0,0,1,0,0,0,SLB
2019-08-01,0,0,2,5,0,5,SLE
2019-08-01,0,0,1,1,0,1,SOM
2019-08-01,0,0,1,49,65,49,SWE
2019-08-01,2,0,0,0,0,2,TGO
2019-08-01,418,1,17,123,0,541,THA
2019-08-01,3,0,0,0,0,3,TLS
2019-08-01,337,2,0,1,0,338,TTO
2019-08-01,14,15,1,1,0,15,TUN
2019-08-01,6,0,13,46,0,52,TUR
2019-08-01,7,7,1,0,19,7,TWN
2019-08-01,2,0,0,0,0,2,TZA
2019-08-01,13,5,3,9,0,22,UKR
2019-08-01,0,0,1,0,0,0,URY
2019-08-01,2255,44,1,584,5,2839,USA
2019-08-01,12,3,2,6,0,18,VEN
2019-08-01,1,0,0,0,0,1,VIR
2019-08-01,42,1,18,172,15,214,VNM
2019-08-01,0,0,1,0,0,0,VUT
2019-08-01,2,0,8,0,0,2,YEM
2019-08-01,1,0,3,1,0,2,ZAF
2019-09-01,1,0,0,0,0,1,ABW
2019-09-01,244,3,0,0,0,244,AGO
2019-09-01,519,1,3,12,0,531,ARE
2019-09-01,0,0,1,0,0,0,ASM
2019-09-01,0,0,1,0,0,0,ATG
2019-09-01,64,4,25,44,0,108,AUS
2019-09-01,0,0,1,5,338,5,BEL
2019-09-01,6,0,0,0,0,6,BEN
2019-09-01,0,0,1,0,0,0,BES
2019-09-01,2,1,1,1,0,3,BGD
2019-09-01,1,0,0,0,0,1,BGR
2019-09-01,5,0,1,1,0,6,BHR
2019-09-01,0,0,2,4,0,4,BHS
2019-09-01,0,0,1,0,0,0,BLZ
2019-09-01,131,11,6,17,0,148,BRA
2019-09-01,129,3,0,0,0,129,BRN
2019-09-01,6,0,8,25,0,31,CAN
2019-09-01,0,0,2,0,0,0,CHL
2019-09-01,300,62,126,255,1777,555,CHN
2019-09-01,11,1,1,0,0,11,CIV
2019-09-01,74,1,0,0,0,74,CMR
2019-09-01,47,0,0,0,0,47,COD
2019-09-01,75,0,0,0,0,75,COG
2019-09-01,5,0,2,0,0,5,COL
2019-09-01,3,0,4,4,0,7,CUB
2019-09-01,0,0,1,0,0,0,CYP
2019-09-01,21,19,2,30,1503,51,DEU
2019-09-01,0,0,1,0,0,0,DJI
2019-09-01,16,2,1,20,512,36,DNK
2019-09-01,0,0,1,0,0,0,DOM
2019-09-01,0,0,4,0,0,0,DZA
2019-09-01,12,2,2,0,0,12,ECU
2019-09-01,183,7,0,7,0,190,EGY
2019-09-01,0,0,2,1,0,1,ERI
2019-09-01,3,8,0,7,0,10,ESP
2019-09-01,0,0,0,1,0,1,EST
2019-09-01,0,0,2,57,5,57,FIN
2019-09-01,0,0,0,1,0,1,FJI
2019-09-01,0,0,4,26,0,26,FRA
2019-09-01,117,0,2,0,0,117,GAB
2019-09-01,173,14,3,16,2308,189,GBR
2019-09-01,1,0,0,0,0,1,GEO
2019-09-01,2,0,6,1,0,3,GHA
2019-09-01,0,0,2,2,0,2,GIN
2019-09-01,0,0,1,7,0,7,GNB
2019-09-01,14,0,0,0,0,14,GNQ
2019-09-01,7,0,0,4,0,11,GRC
2019-09-01,0,0,1,0,0,0,GUF
2019-09-01,16,0,0,3,0,19,HRV
2019-09-01,564,62,71,127,0,691,IDN
2019-09-01,182,2,33,13,0,195,IND
2019-09-01,3,0,2,3,7,6,IRL
2019-09-01,165,3,0,2,0,167,IRN
2019-09-01,1,0,1,8,0,9,IRQ
2019-09-01,0,0,1,3,0,3,ISL
2019-09-01,4,0,3,0,0,4,ISR
2019-09-01,103,6,3,3,0,106,ITA
2019-09-01,0,0,1,1,0,1,JAM
2019-09-01,0,0,0,1,0,1,JEY
2019-09-01,18,10,45,38,0,56,JPN
2019-09-01,0,0,3,0,0,0,KEN
2019-09-01,3,0,1,1,0,4,KHM
2019-09-01,7,0,57,44,13,51,KOR
2019-09-01,32,1,0,36,0,68,KWT
2019-09-01,0,0,1,0,0,0,LBN
2019-09-01,0,0,5,1,0,1,LBR
2019-09-01,10,0,1,0,0,10,LBY
2019-09-01,0,0,4,5,0,5,LKA
2019-09-01,1,0,0,0,0,1,LTU
2019-09-01,0,0,1,0,0,0,LVA
2019-09-01,0,0,1,0,0,0,MDG
2019-09-01,192,3,12,2,0,194,MEX
2019-09-01,5,4,18,10,0,15,MMR
2019-09-01,0,0,1,3,0,3,MOZ
2019-09-01,0,0,1,0,0,0,MRT
2019-09-01,325,20,45,44,0,369,MYS
2019-09-01,8,0,0,0,0,8,NAM
2019-09-01,0,0,1,0,0,0,NCL
2019-09-01,431,3,5,1,0,432,NGA
2019-09-01,0,0,2,1,0,1,NIC
2019-09-01,111,12,1,8,292,119,NLD
2019-09-01,18,0,0,8,2,26,NOR
2019-09-01,7,0,1,5,0,12,NZL
2019-09-01,14,0,11,2,0,16,None
2019-09-01,6,0,4,1,0,7,OMN
2019-09-01,0,0,2,0,0,0,PAK
2019-09-01,0,0,4,0,0,0,PAN
2019-09-01,94,1,4,2,0,96,PER
2019-09-01,7,0,14,32,0,39,PHL
2019-09-01,2,0,1,1,0,3,PNG
2019-09-01,9,4,0,5,3,14,POL
2019-09-01,1,0,4,4,0,5,PRK
2019-09-01,0,0,1,0,0,0,PRT
2019-09-01,169,0,4,2,0,171,QAT
2019-09-01,8,1,0,0,0,8,ROU
2019-09-01,11,2,9,8,0,19,RUS
2019-09-01,718,26,7,2,0,720,SAU
2019-09-01,1,1,2,0,0,1,SDN
2019-09-01,0,0,0,40,0,40,SGP
2019-09-01,0,0,1,0,0,0,SLB
2019-09-01,0,0,1,5,0,5,SLE
2019-09-01,0,0,1,1,0,1,SOM
2019-09-01,0,0,1,49,65,49,SWE
2019-09-01,2,0,0,0,0,2,TGO
2019-09-01,419,1,17,136,0,555,THA
2019-09-01,3,0,0,0,0,3,TLS
2019-09-01,336,2,0,1,0,337,TTO
2019-09-01,14,15,1,0,0,14,TUN
2019-09-01,6,0,12,47,0,53,TUR
2019-09-01,7,8,1,0,22,7,TWN
2019-09-01,2,0,0,0,0,2,TZA
2019-09-01,14,5,3,10,0,24,UKR
2019-09-01,0,0,1,0,0,0,URY
2019-09-01,2233,44,1,557,5,2790,USA
2019-09-01,13,3,3,6,0,19,VEN
2019-09-01,1,0,0,0,0,1,VIR
2019-09-01,40,2,17,179,16,219,VNM
2019-09-01,0,0,1,0,0,0,VUT
2019-09-01,3,0,7,0,0,3,YEM
2019-09-01,1,0,3,1,0,2,ZAF
2019-10-01,1,0,0,0,0,1,ABW
2019-10-01,243,2,0,0,0,243,AGO
2019-10-01,519,1,2,13,0,532,ARE
2019-10-01,0,0,1,0,0,0,ASM
2019-10-01,0,0,1,0,0,0,ATG
2019-10-01,64,4,28,40,0,104,AUS
2019-10-01,0,0,1,5,342,5,BEL
2019-10-01,6,0,0,0,0,6,BEN
2019-10-01,0,0,1,0,0,0,BES
2019-10-01,2,1,1,1,0,3,BGD
2019-10-01,1,0,0,0,0,1,BGR
2019-10-01,4,0,1,1,0,5,BHR
2019-10-01,0,0,2,4,0,4,BHS
2019-10-01,0,0,1,0,0,0,BLZ
2019-10-01,128,11,7,20,0,148,BRA
2019-10-01,128,4,0,0,0,128,BRN
2019-10-01,6,0,6,22,0,28,CAN
2019-10-01,0,0,2,0,0,0,CHL
2019-10-01,301,52,130,263,1856,564,CHN
2019-10-01,11,1,1,0,0,11,CIV
2019-10-01,76,1,0,0,0,76,CMR
2019-10-01,47,0,0,0,0,47,COD
2019-10-01,75,0,0,0,0,75,COG
2019-10-01,5,0,2,0,0,5,COL
2019-10-01,3,0,4,4,0,7,CUB
2019-10-01,1,0,2,0,0,1,CYP
2019-10-01,21,19,2,29,1502,50,DEU
2019-10-01,0,0,1,0,0,0,DJI
2019-10-01,18,2,1,20,512,38,DNK
2019-10-01,0,0,1,0,0,0,DOM
2019-10-01,0,0,4,0,0,0,DZA
2019-10-01,12,2,2,0,0,12,ECU
2019-10-01,187,6,1,5,0,192,EGY
2019-10-01,0,0,2,1,0,1,ERI
2019-10-01,3,8,0,7,0,10,ESP
2019-10-01,0,0,0,1,0,1,EST
2019-10-01,0,0,2,57,5,57,FIN
2019-10-01,0,0,0,1,0,1,FJI
2019-10-01,0,0,4,25,0,25,FRA
2019-10-01,118,0,2,0,0,118,GAB
2019-10-01,169,12,2,16,2318,185,GBR
2019-10-01,1,0,0,0,0,1,GEO
2019-10-01,2,0,5,1,0,3,GHA
2019-10-01,0,0,2,3,0,3,GIN
2019-10-01,0,0,1,9,0,9,GNB
2019-10-01,14,0,0,0,0,14,GNQ
2019-10-01,6,0,0,2,0,8,GRC
2019-10-01,0,0,1,0,0,0,GUF
2019-10-01,16,0,0,3,0,19,HRV
2019-10-01,569,64,70,127,0,696,IDN
2019-10-01,182,2,39,13,0,195,IND
2019-10-01,2,0,1,3,7,5,IRL
2019-10-01,163,3,0,1,0,164,IRN
2019-10-01,1,0,1,7,0,8,IRQ
2019-10-01,0,0,1,2,0,2,ISL
2019-10-01,4,0,3,0,0,4,ISR
2019-10-01,103,6,3,3,0,106,ITA
2019-10-01,0,0,2,1,0,1,JAM
2019-10-01,0,0,0,1,0,1,JEY
2019-10-01,18,10,43,39,0,57,JPN
2019-10-01,0,0,3,0,0,0,KEN
2019-10-01,3,0,1,0,0,3,KHM
2019-10-01,7,0,58,47,13,54,KOR
2019-10-01,30,1,0,37,0,67,KWT
2019-10-01,0,0,1,0,0,0,LBN
2019-10-01,0,0,5,1,0,1,LBR
2019-10-01,10,0,1,0,0,10,LBY
2019-10-01,0,0,4,5,0,5,LKA
2019-10-01,1,0,0,0,0,1,LTU
2019-10-01,0,0,1,1,0,1,LVA
2019-10-01,0,0,1,0,0,0,MDG
2019-10-01,191,3,12,2,0,193,MEX
2019-10-01,5,4,19,8,0,13,MMR
2019-10-01,0,0,1,3,0,3,MOZ
2019-10-01,0,0,1,0,0,0,MRT
2019-10-01,328,18,47,46,0,374,MYS
2019-10-01,9,0,0,0,0,9,NAM
2019-10-01,0,0,1,0,0,0,NCL
2019-10-01,427,3,5,0,0,427,NGA
2019-10-01,0,0,2,1,0,1,NIC
2019-10-01,111,13,1,8,292,119,NLD
2019-10-01,17,0,0,5,2,22,NOR
2019-10-01,7,0,1,5,0,12,NZL
2019-10-01,15,0,10,3,0,18,None
2019-10-01,6,0,4,1,0,7,OMN
2019-10-01,0,0,2,0,0,0,PAK
2019-10-01,0,0,4,1,0,1,PAN
2019-10-01,95,1,5,2,0,97,PER
2019-10-01,7,0,11,30,0,37,PHL
2019-10-01,2,0,1,1,0,3,PNG
2019-10-01,9,4,0,5,3,14,POL
2019-10-01,0,0,4,3,0,3,PRK
2019-10-01,0,0,1,0,0,0,PRT
2019-10-01,166,0,4,2,0,168,QAT
2019-10-01,8,1,0,0,0,8,ROU
2019-10-01,12,2,8,6,0,18,RUS
2019-10-01,719,22,7,2,0,721,SAU
2019-10-01,1,0,2,0,0,1,SDN
2019-10-01,2,0,0,0,0,2,SEN
2019-10-01,0,0,0,29,0,29,SGP
2019-10-01,0,0,1,0,0,0,SLB
2019-10-01,0,0,1,5,0,5,SLE
2019-10-01,0,0,1,1,0,1,SOM
2019-10-01,0,0,1,49,65,49,SWE
2019-10-01,2,0,0,0,0,2,TGO
2019-10-01,421,1,18,136,0,557,THA
2019-10-01,3,0,0,0,0,3,TLS
2019-10-01,338,1,0,1,0,339,TTO
2019-10-01,13,14,1,0,0,13,TUN
2019-10-01,6,0,12,49,0,55,TUR
2019-10-01,7,7,1,0,22,7,TWN
2019-10-01,2,0,0,0,0,2,TZA
2019-10-01,14,5,3,9,0,23,UKR
2019-10-01,0,0,1,0,0,0,URY
2019-10-01,2205,44,2,540,5,2745,USA
2019-10-01,18,3,3,4,0,22,VEN
2019-10-01,1,0,0,0,0,1,VIR
2019-10-01,40,2,17,185,18,225,VNM
2019-10-01,0,0,1,0,0,0,VUT
2019-10-01,4,0,8,0,0,4,YEM
2019-10-01,1,0,3,1,0,2,ZAF
2019-11-01,1,0,0,0,0,1,ABW
2019-11-01,243,1,0,0,0,243,AGO
2019-11-01,516,1,2,12,0,528,ARE
2019-11-01,0,0,1,0,0,0,ASM
2019-11-01,0,0,1,0,0,0,ATG
2019-11-01,64,3,27,40,0,104,AUS
2019-11-01,0,0,1,5,370,5,BEL
2019-11-01,6,0,0,0,0,6,BEN
2019-11-01,0,0,1,0,0,0,BES
2019-11-01,2,1,1,2,0,4,BGD
2019-11-01,1,0,0,0,0,1,BGR
2019-11-01,3,0,1,0,0,3,BHR
2019-11-01,0,0,2,3,0,3,BHS
2019-11-01,129,11,7,17,0,146,BRA
2019-11-01,127,4,0,0,0,127,BRN
2019-11-01,6,0,7,16,0,22,CAN
2019-11-01,0,0,1,0,0,0,CHL
2019-11-01,294,53,122,271,1939,565,CHN
2019-11-01,11,1,1,0,0,11,CIV
2019-11-01,76,1,0,0,0,76,CMR
2019-11-01,48,0,0,0,0,48,COD
2019-11-01,75,0,0,0,0,75,COG
2019-11-01,5,0,2,0,0,5,COL
2019-11-01,3,0,5,3,0,6,CUB
2019-11-01,1,0,2,0,0,1,CYP
2019-11-01,21,17,2,29,1499,50,DEU
2019-11-01,0,0,1,0,0,0,DJI
2019-11-01,18,2,1,20,512,38,DNK
2019-11-01,0,0,1,0,0,0,DOM
2019-11-01,0,0,4,0,0,0,DZA
2019-11-01,10,1,2,0,0,10,ECU
2019-11-01,183,5,1,5,0,188,EGY
2019-11-01,0,0,2,1,0,1,ERI
2019-11-01,3,8,0,7,0,10,ESP
2019-11-01,0,0,0,1,0,1,EST
2019-11-01,0,0,2,56,5,56,FIN
2019-11-01,0,0,4,24,0,24,FRA
2019-11-01,119,0,2,0,0,119,GAB
2019-11-01,168,11,2,16,2318,184,GBR
2019-11-01,1,0,0,0,0,1,GEO
2019-11-01,2,0,5,1,0,3,GHA
2019-11-01,0,0,1,3,0,3,GIN
2019-11-01,0,0,1,8,0,8,GNB
2019-11-01,14,0,0,0,0,14,GNQ
2019-11-01,6,0,0,1,0,7,GRC
2019-11-01,16,0,0,3,0,19,HRV
2019-11-01,560,53,66,127,0,687,IDN
2019-11-01,182,3,36,13,0,195,IND
2019-11-01,2,0,1,3,7,5,IRL
2019-11-01,163,4,0,1,0,164,IRN
2019-11-01,1,0,1,7,0,8,IRQ
2019-11-01,0,0,1,1,0,1,ISL
2019-11-01,4,0,3,0,0,4,ISR
2019-11-01,104,6,3,4,0,108,ITA
2019-11-01,0,0,2,1,0,1,JAM
2019-11-01,0,0,0,1,0,1,JEY
2019-11-01,20,9,44,39,0,59,JPN
2019-11-01,0,0,3,0,0,0,KEN
2019-11-01,3,0,1,0,0,3,KHM
2019-11-01,6,0,57,56,13,62,KOR
2019-11-01,29,1,0,35,0,64,KWT
2019-11-01,0,0,1,0,0,0,LBN
2019-11-01,0,0,5,1,0,1,LBR
2019-11-01,10,0,1,0,0,10,LBY
2019-11-01,0,0,4,4,0,4,LKA
2019-11-01,1,0,0,0,0,1,LTU
2019-11-01,0,0,1,1,0,1,LVA
2019-11-01,0,0,1,0,0,0,MDG
2019-11-01,194,5,14,2,0,196,MEX
2019-11-01,5,2,17,8,0,13,MMR
2019-11-01,0,0,1,2,0,2,MOZ
2019-11-01,0,0,1,0,0,0,MRT
2019-11-01,329,18,46,45,0,374,MYS
2019-11-01,7,0,0,0,0,7,NAM
2019-11-01,0,0,1,0,0,0,NCL
2019-11-01,422,4,2,0,0,422,NGA
2019-11-01,0,0,2,1,0,1,NIC
2019-11-01,114,13,1,5,301,119,NLD
2019-11-01,18,0,0,5,2,23,NOR
2019-11-01,7,0,1,5,0,12,NZL
2019-11-01,18,0,10,2,0,20,None
2019-11-01,6,0,4,2,0,8,OMN
2019-11-01,0,0,2,0,0,0,PAK
2019-11-01,0,0,6,2,0,2,PAN
2019-11-01,95,1,4,1,0,96,PER
2019-11-01,7,0,10,24,0,31,PHL
2019-11-01,2,0,0,1,0,3,PNG
2019-11-01,9,3,0,5,3,14,POL
2019-11-01,0,0,2,3,0,3,PRK
2019-11-01,0,0,1,0,0,0,PRT
2019-11-01,167,0,4,2,0,169,QAT
2019-11-01,8,0,0,0,0,8,ROU
2019-11-01,12,3,5,5,0,17,RUS
2019-11-01,720,22,8,2,0,722,SAU
2019-11-01,1,0,2,0,0,1,SDN
2019-11-01,2,0,0,0,0,2,SEN
2019-11-01,0,0,0,29,0,29,SGP
2019-11-01,0,0,1,0,0,0,SLB
2019-11-01,0,0,0,4,0,4,SLE
2019-11-01,0,0,2,1,0,1,SOM
2019-11-01,0,0,1,48,65,48,SWE
2019-11-01,3,0,0,0,0,3,TGO
2019-11-01,420,1,19,130,0,550,THA
2019-11-01,3,0,0,0,0,3,TLS
2019-11-01,331,1,0,1,0,332,TTO
2019-11-01,13,14,1,0,0,13,TUN
2019-11-01,6,0,12,48,0,54,TUR
2019-11-01,7,7,1,0,22,7,TWN
2019-11-01,2,0,0,0,0,2,TZA
2019-11-01,14,5,3,7,0,21,UKR
2019-11-01,0,0,1,0,0,0,URY
2019-11-01,2151,45,2,513,5,2664,USA
2019-11-01,15,3,2,3,0,18,VEN
2019-11-01,1,0,0,0,0,1,VIR
2019-11-01,42,2,19,197,21,239,VNM
2019-11-01,0,0,1,0,0,0,VUT
2019-11-01,4,0,7,0,0,4,YEM
2019-11-01,1,0,3,2,0,3,ZAF
2019-12-01,1,0,0,0,0,1,ABW
2019-12-01,242,2,0,0,0,242,AGO
2019-12-01,519,1,2,11,0,530,ARE
2019-12-01,0,0,1,0,0,0,ASM
2019-12-01,0,0,1,0,0,0,ATG
2019-12-01,69,2,24,38,0,107,AUS
2019-12-01,0,0,1,5,387,5,BEL
2019-12-01,6,0,0,0,0,6,BEN
2019-12-01,0,0,1,0,0,0,BES
2019-12-01,2,1,1,1,0,3,BGD
2019-12-01,1,0,0,0,0,1,BGR
2019-12-01,3,0,1,0,0,3,BHR
2019-12-01,0,0,2,3,0,3,BHS
2019-12-01,130,12,8,13,0,143,BRA
2019-12-01,124,4,0,0,0,124,BRN
2019-12-01,6,0,8,10,0,16,CAN
2019-12-01,0,0,1,0,0,0,CHL
2019-12-01,298,57,122,304,2002,602,CHN
2019-12-01,11,1,1,0,0,11,CIV
2019-12-01,76,1,0,0,0,76,CMR
2019-12-01,48,0,0,0,0,48,COD
2019-12-01,76,0,0,0,0,76,COG
2019-12-01,5,0,2,1,0,6,COL
2019-12-01,3,0,5,2,0,5,CUB
2019-12-01,0,0,2,0,0,0,CYP
2019-12-01,21,16,2,29,1501,50,DEU
2019-12-01,0,0,1,0,0,0,DJI
2019-12-01,19,1,1,22,512,41,DNK
2019-12-01,0,0,1,0,0,0,DOM
2019-12-01,0,0,4,0,0,0,DZA
2019-12-01,10,1,2,0,0,10,ECU
2019-12-01,179,5,1,6,0,185,EGY
2019-12-01,0,0,2,1,0,1,ERI
2019-12-01,0,0,1,0,0,0,ESH
2019-12-01,2,8,0,6,0,8,ESP
2019-12-01,0,0,0,1,0,1,EST
2019-12-01,0,0,1,50,5,50,FIN
2019-12-01,0,0,4,23,0,23,FRA
2019-12-01,120,0,2,0,0,120,GAB
2019-12-01,169,12,2,18,2318,187,GBR
2019-12-01,1,0,0,0,0,1,GEO
2019-12-01,2,0,7,1,0,3,GHA
2019-12-01,0,0,1,1,0,1,GIN
2019-12-01,0,0,1,4,0,4,GNB
2019-12-01,13,0,0,0,0,13,GNQ
2019-12-01,6,0,0,2,0,8,GRC
2019-12-01,0,0,1,0,0,0,GUY
2019-12-01,16,0,0,3,0,19,HRV
2019-12-01,557,46,64,127,0,684,IDN
2019-12-01,183,4,35,12,0,195,IND
2019-12-01,2,0,1,3,7,5,IRL
2019-12-01,161,4,0,0,0,161,IRN
2019-12-01,1,1,0,6,0,7,IRQ
2019-12-01,0,0,0,1,0,1,ISL
2019-12-01,4,0,3,0,0,4,ISR
2019-12-01,104,7,3,5,0,109,ITA
2019-12-01,0,0,2,1,0,1,JAM
2019-12-01,0,0,0,2,0,2,JEY
2019-12-01,20,9,45,39,0,59,JPN
2019-12-01,0,0,3,0,0,0,KEN
2019-12-01,3,0,1,1,0,4,KHM
2019-12-01,6,0,59,57,13,63,KOR
2019-12-01,30,1,0,32,0,62,KWT
2019-12-01,0,0,1,0,0,0,LBN
2019-12-01,0,0,7,2,0,2,LBR
2019-12-01,10,0,1,0,0,10,LBY
2019-12-01,0,0,4,3,0,3,LKA
2019-12-01,1,0,0,0,0,1,LTU
2019-12-01,0,0,1,0,0,0,LVA
2019-12-01,0,0,1,0,0,0,MDG
2019-12-01,194,4,14,2,0,196,MEX
2019-12-01,4,1,17,10,0,14,MMR
2019-12-01,1,0,1,2,0,3,MOZ
2019-12-01,1,0,1,0,0,1,MRT
2019-12-01,328,12,50,42,0,370,MYS
2019-12-01,7,0,0,0,0,7,NAM
2019-12-01,0,0,1,0,0,0,NCL
2019-12-01,424,4,2,1,0,425,NGA
2019-12-01,0,0,2,1,0,1,NIC
2019-12-01,112,13,1,5,310,117,NLD
2019-12-01,20,0,0,6,2,26,NOR
2019-12-01,7,0,1,5,0,12,NZL
2019-12-01,19,0,10,5,0,24,None
2019-12-01,7,0,4,2,0,9,OMN
2019-12-01,0,0,2,0,0,0,PAK
2019-12-01,0,0,6,2,0,2,PAN
2019-12-01,96,1,3,1,0,97,PER
2019-12-01,7,0,8,29,0,36,PHL
2019-12-01,2,0,1,1,0,3,PNG
2019-12-01,9,3,0,5,3,14,POL
2019-12-01,0,0,2,3,0,3,PRK
2019-12-01,0,0,1,0,0,0,PRT
2019-12-01,166,0,4,2,0,168,QAT
2019-12-01,8,0,0,0,0,8,ROU
2019-12-01,11,2,5,5,0,16,RUS
2019-12-01,718,23,7,2,0,720,SAU
2019-12-01,1,0,2,0,0,1,SDN
2019-12-01,2,0,0,0,0,2,SEN
2019-12-01,0,0,0,37,0,37,SGP
2019-12-01,0,0,1,0,0,0,SLB
2019-12-01,0,0,0,3,0,3,SLE
2019-12-01,0,0,2,1,0,1,SOM
2019-12-01,0,0,1,47,65,47,SWE
2019-12-01,3,0,0,0,0,3,TGO
2019-12-01,415,1,19,128,0,543,THA
2019-12-01,3,0,0,0,0,3,TLS
2019-12-01,321,1,0,1,0,322,TTO
2019-12-01,14,15,1,0,0,14,TUN
2019-12-01,6,0,11,49,0,55,TUR
2019-12-01,8,7,1,0,22,8,TWN
2019-12-01,1,0,0,0,0,1,TZA
2019-12-01,14,5,3,8,0,22,UKR
2019-12-01,0,0,1,0,0,0,URY
2019-12-01,2087,44,1,513,5,2600,USA
2019-12-01,15,3,2,2,0,17,VEN
2019-12-01,1,0,0,0,0,1,VIR
2019-12-01,40,2,19,198,21,238,VNM
2019-12-01,0,0,1,0,0,0,VUT
2019-12-01,4,0,7,0,0,4,YEM
2019-12-01,1,0,3,2,0,3,ZAF
2020-01-01,1,0,0,0,0,1,ABW
2020-01-01,245,2,0,0,0,245,AGO
2020-01-01,517,1,2,11,0,528,ARE
2020-01-01,0,0,1,0,0,0,ASM
2020-01-01,0,0,1,0,0,0,ATG
2020-01-01,71,2,25,39,0,110,AUS
2020-01-01,0,0,1,5,401,5,BEL
2020-01-01,6,0,0,0,0,6,BEN
2020-01-01,0,0,1,0,0,0,BES
2020-01-01,2,3,1,1,0,3,BGD
2020-01-01,1,0,0,0,0,1,BGR
2020-01-01,3,0,1,0,0,3,BHR
2020-01-01,0,0,3,3,0,3,BHS
2020-01-01,130,12,7,16,0,146,BRA
2020-01-01,124,4,0,0,0,124,BRN
2020-01-01,6,0,7,9,0,15,CAN
2020-01-01,0,0,1,0,0,0,CHL
2020-01-01,303,60,126,344,2113,647,CHN
2020-01-01,11,1,1,0,0,11,CIV
2020-01-01,77,2,0,0,0,77,CMR
2020-01-01,49,0,0,0,0,49,COD
2020-01-01,75,0,0,0,0,75,COG
2020-01-01,5,0,2,3,0,8,COL
2020-01-01,3,0,5,2,0,5,CUB
2020-01-01,0,0,1,0,0,0,CYP
2020-01-01,21,16,2,29,1500,50,DEU
2020-01-01,0,0,1,0,0,0,DJI
2020-01-01,20,1,1,20,512,40,DNK
2020-01-01,0,0,1,0,0,0,DOM
2020-01-01,0,0,4,0,0,0,DZA
2020-01-01,11,2,2,0,0,11,ECU
2020-01-01,175,5,1,6,0,181,EGY
2020-01-01,0,0,2,1,0,1,ERI
2020-01-01,0,0,1,0,0,0,ESH
2020-01-01,3,8,0,6,0,9,ESP
2020-01-01,0,0,0,1,0,1,EST
2020-01-01,0,0,0,48,5,48,FIN
2020-01-01,0,0,4,24,0,24,FRA
2020-01-01,120,0,1,0,0,120,GAB
2020-01-01,167,12,2,19,2312,186,GBR
2020-01-01,1,0,0,0,0,1,GEO
2020-01-01,1,0,7,1,0,2,GHA
2020-01-01,0,0,2,1,0,1,GIN
2020-01-01,0,0,1,4,0,4,GNB
2020-01-01,13,0,0,0,0,13,GNQ
2020-01-01,5,0,0,2,0,7,GRC
2020-01-01,0,0,1,0,0,0,GUY
2020-01-01,16,0,0,3,0,19,HRV
2020-01-01,567,49,63,130,0,697,IDN
2020-01-01,185,4,33,14,0,199,IND
2020-01-01,2,0,1,3,7,5,IRL
2020-01-01,161,4,0,0,0,161,IRN
2020-01-01,1,1,0,5,0,6,IRQ
2020-01-01,0,0,0,1,0,1,ISL
2020-01-01,4,0,2,0,0,4,ISR
2020-01-01,103,7,3,6,0,109,ITA
2020-01-01,0,0,0,1,0,1,JAM
2020-01-01,0,0,0,3,0,3,JEY
2020-01-01,19,11,45,39,0,58,JPN
2020-01-01,0,0,3,1,0,1,KEN
2020-01-01,3,0,1,3,0,6,KHM
2020-01-01,6,0,57,67,12,73,KOR
2020-01-01,32,1,0,35,0,67,KWT
2020-01-01,0,0,9,2,0,2,LBR
2020-01-01,10,0,1,0,0,10,LBY
2020-01-01,0,0,4,3,0,3,LKA
2020-01-01,1,0,0,0,0,1,LTU
2020-01-01,0,0,1,0,0,0,LVA
2020-01-01,0,0,1,0,0,0,MDG
2020-01-01,192,3,15,2,0,194,MEX
2020-01-01,4,0,18,12,0,16,MMR
2020-01-01,1,0,1,2,0,3,MOZ
2020-01-01,1,0,1,0,0,1,MRT
2020-01-01,333,12,54,54,0,387,MYS
2020-01-01,8,1,0,0,0,8,NAM
2020-01-01,0,0,1,0,0,0,NCL
2020-01-01,433,4,2,1,0,434,NGA
2020-01-01,0,0,2,1,0,1,NIC
2020-01-01,112,14,1,7,326,119,NLD
2020-01-01,21,0,0,6,2,27,NOR
2020-01-01,7,0,1,6,0,13,NZL
2020-01-01,20,0,11,6,0,26,None
2020-01-01,7,0,3,2,0,9,OMN
2020-01-01,0,0,2,0,0,0,PAK
2020-01-01,0,0,6,2,0,2,PAN
2020-01-01,96,1,2,0,0,96,PER
2020-01-01,7,0,9,39,0,46,PHL
2020-01-01,2,0,1,2,0,4,PNG
2020-01-01,9,3,0,5,3,14,POL
2020-01-01,0,0,2,4,0,4,PRK
2020-01-01,0,0,1,0,0,0,PRT
2020-01-01,167,0,5,3,0,170,QAT
2020-01-01,8,0,0,0,0,8,ROU
2020-01-01,10,2,5,5,0,15,RUS
2020-01-01,719,23,8,2,0,721,SAU
2020-01-01,1,0,2,0,0,1,SDN
2020-01-01,3,0,0,0,0,3,SEN
2020-01-01,0,0,0,39,0,39,SGP
2020-01-01,0,0,1,0,0,0,SLB
2020-01-01,0,0,0,3,0,3,SLE
2020-01-01,0,0,0,1,0,1,SLV
2020-01-01,0,0,1,1,0,1,SOM
2020-01-01,1,0,0,0,0,1,SUR
2020-01-01,0,0,1,47,65,47,SWE
2020-01-01,3,0,0,0,0,3,TGO
2020-01-01,414,1,21,153,0,567,THA
2020-01-01,3,0,0,0,0,3,TLS
2020-01-01,327,2,0,1,0,328,TTO
2020-01-01,14,15,1,0,0,14,TUN
2020-01-01,6,0,11,50,0,56,TUR
2020-01-01,8,7,1,0,22,8,TWN
2020-01-01,1,0,0,0,0,1,TZA
2020-01-01,14,5,3,9,0,23,UKR
2020-01-01,0,0,1,0,0,0,URY
2020-01-01,2118,44,1,543,5,2661,USA
2020-01-01,13,3,2,3,0,16,VEN
2020-01-01,1,0,0,0,0,1,VIR
2020-01-01,41,2,22,214,23,255,VNM
2020-01-01,0,0,1,0,0,0,VUT
2020-01-01,4,0,8,0,0,4,YEM
2020-01-01,1,0,3,1,0,2,ZAF
2020-02-01,1,0,1,0,0,1,ABW
2020-02-01,248,1,0,0,0,248,AGO
2020-02-01,519,1,2,10,0,529,ARE
2020-02-01,0,0,1,0,0,0,ASM
2020-02-01,0,0,1,0,0,0,ATG
2020-02-01,73,4,30,46,0,119,AUS
2020-02-01,0,0,1,5,405,5,BEL
2020-02-01,6,0,0,0,0,6,BEN
2020-02-01,0,0,1,0,0,0,BES
2020-02-01,2,3,1,1,0,3,BGD
2020-02-01,1,0,0,0,0,1,BGR
2020-02-01,3,0,1,0,0,3,BHR
2020-02-01,0,0,4,5,0,5,BHS
2020-02-01,135,16,8,22,0,157,BRA
2020-02-01,125,4,0,0,0,125,BRN
2020-02-01,6,0,7,12,0,18,CAN
2020-02-01,0,0,1,0,0,0,CHL
2020-02-01,308,69,133,389,2160,697,CHN
2020-02-01,11,1,1,0,0,11,CIV
2020-02-01,76,1,0,0,0,76,CMR
2020-02-01,49,0,0,0,0,49,COD
2020-02-01,75,0,0,0,0,75,COG
2020-02-01,5,0,2,3,0,8,COL
2020-02-01,3,0,5,2,0,5,CUB
2020-02-01,0,0,1,0,0,0,CYP
2020-02-01,20,17,2,29,1501,49,DEU
2020-02-01,0,0,1,0,0,0,DJI
2020-02-01,18,2,1,18,513,36,DNK
2020-02-01,0,0,1,0,0,0,DOM
2020-02-01,0,0,4,0,0,0,DZA
2020-02-01,11,2,3,0,0,11,ECU
2020-02-01,176,5,0,6,0,182,EGY
2020-02-01,0,0,3,1,0,1,ERI
2020-02-01,0,0,1,0,0,0,ESH
2020-02-01,3,8,0,6,0,9,ESP
2020-02-01,0,0,0,1,0,1,EST
2020-02-01,0,0,0,50,5,50,FIN
2020-02-01,0,0,5,26,0,26,FRA
2020-02-01,120,0,1,0,0,120,GAB
2020-02-01,163,13,3,18,2312,181,GBR
2020-02-01,1,0,0,0,0,1,GEO
2020-02-01,3,0,7,1,0,4,GHA
2020-02-01,0,0,2,1,0,1,GIN
2020-02-01,0,0,2,7,0,7,GNB
2020-02-01,14,0,0,0,0,14,GNQ
2020-02-01,5,0,0,2,0,7,GRC
2020-02-01,0,0,2,0,0,0,GUY
2020-02-01,16,0,0,3,0,19,HRV
2020-02-01,573,72,67,162,0,735,IDN
2020-02-01,188,4,33,18,0,206,IND
2020-02-01,3,0,1,3,7,6,IRL
2020-02-01,161,3,0,0,0,161,IRN
2020-02-01,1,2,0,6,0,7,IRQ
2020-02-01,0,0,0,2,0,2,ISL
2020-02-01,4,0,2,0,0,4,ISR
2020-02-01,103,8,3,6,0,109,ITA
2020-02-01,0,0,0,1,0,1,JAM
2020-02-01,0,0,0,5,0,5,JEY
2020-02-01,19,12,46,36,0,55,JPN
2020-02-01,0,0,3,1,0,1,KEN
2020-02-01,3,0,1,3,0,6,KHM
2020-02-01,6,0,60,72,12,78,KOR
2020-02-01,32,2,0,37,0,69,KWT
2020-02-01,0,0,11,2,0,2,LBR
2020-02-01,10,0,1,0,0,10,LBY
2020-02-01,0,0,4,3,0,3,LKA
2020-02-01,1,0,0,0,0,1,LTU
2020-02-01,0,0,1,0,0,0,LVA
2020-02-01,0,0,1,0,0,0,MDG
2020-02-01,195,3,16,2,0,197,MEX
2020-02-01,4,2,19,13,0,17,MMR
2020-02-01,0,0,1,0,0,0,MNP
2020-02-01,0,0,1,2,0,2,MOZ
2020-02-01,1,0,1,0,0,1,MRT
2020-02-01,343,40,69,67,0,410,MYS
2020-02-01,8,1,0,0,0,8,NAM
2020-02-01,437,4,2,1,0,438,NGA
2020-02-01,0,0,2,1,0,1,NIC
2020-02-01,115,13,1,7,353,122,NLD
2020-02-01,21,0,0,5,2,26,NOR
2020-02-01,7,0,1,6,0,13,NZL
2020-02-01,20,0,11,5,0,25,None
2020-02-01,8,0,2,3,0,11,OMN
2020-02-01,0,0,2,0,0,0,PAK
2020-02-01,0,2,6,4,0,4,PAN
2020-02-01,96,1,2,0,0,96,PER
2020-02-01,7,0,10,60,0,67,PHL
2020-02-01,2,0,1,2,0,4,PNG
2020-02-01,10,3,0,5,3,15,POL
2020-02-01,0,0,2,4,0,4,PRK
2020-02-01,0,0,1,0,0,0,PRT
2020-02-01,166,0,5,3,0,169,QAT
2020-02-01,8,0,0,0,0,8,ROU
2020-02-01,8,2,6,4,0,12,RUS
2020-02-01,722,25,8,2,0,724,SAU
2020-02-01,1,0,2,0,0,1,SDN
2020-02-01,3,0,0,0,0,3,SEN
2020-02-01,0,0,0,36,0,36,SGP
2020-02-01,0,0,1,0,0,0,SLB
2020-02-01,0,0,0,3,0,3,SLE
2020-02-01,0,0,0,1,0,1,SLV
2020-02-01,0,0,1,1,0,1,SOM
2020-02-01,1,1,0,0,0,1,SUR
2020-02-01,0,0,1,47,65,47,SWE
2020-02-01,3,0,0,0,0,3,TGO
2020-02-01,414,2,21,187,0,601,THA
2020-02-01,3,0,0,0,0,3,TLS
2020-02-01,328,1,0,1,0,329,TTO
2020-02-01,14,14,1,0,0,14,TUN
2020-02-01,6,1,12,48,0,54,TUR
2020-02-01,8,7,2,0,22,8,TWN
2020-02-01,1,1,0,0,0,1,TZA
2020-02-01,14,6,3,12,0,26,UKR
2020-02-01,0,0,1,0,0,0,URY
2020-02-01,2177,47,1,594,5,2771,USA
2020-02-01,12,3,3,5,0,17,VEN
2020-02-01,1,0,0,0,0,1,VIR
2020-02-01,42,4,21,236,28,278,VNM
2020-02-01,0,0,1,0,0,0,VUT
2020-02-01,4,0,8,1,0,5,YEM
2020-02-01,1,0,4,1,0,2,ZAF
2020-03-01,1,0,1,0,0,1,ABW
2020-03-01,248,1,0,0,0,248,AGO
2020-03-01,522,1,2,11,0,533,ARE
2020-03-01,0,0,1,0,0,0,ASM
2020-03-01,0,0,1,0,0,0,ATG
2020-03-01,72,4,31,52,0,124,AUS
2020-03-01,0,0,1,5,405,5,BEL
2020-03-01,6,0,0,0,0,6,BEN
2020-03-01,0,0,1,0,0,0,BES
2020-03-01,2,3,0,0,0,2,BGD
2020-03-01,1,0,0,0,0,1,BGR
2020-03-01,3,0,1,0,0,3,BHR
2020-03-01,0,0,4,5,0,5,BHS
2020-03-01,138,17,7,32,0,170,BRA
2020-03-01,125,4,0,0,0,125,BRN
2020-03-01,6,0,7,21,0,27,CAN
2020-03-01,0,0,2,0,0,0,CHL
2020-03-01,315,68,143,417,2183,732,CHN
2020-03-01,11,1,1,0,0,11,CIV
2020-03-01,77,0,0,0,0,77,CMR
2020-03-01,49,0,0,0,0,49,COD
2020-03-01,76,0,0,0,0,76,COG
2020-03-01,5,0,1,3,0,8,COL
2020-03-01,3,0,5,2,0,5,CUB
2020-03-01,0,0,1,0,0,0,CYP
2020-03-01,19,17,2,29,1504,48,DEU
2020-03-01,0,0,1,0,0,0,DJI
2020-03-01,18,2,0,18,513,36,DNK
2020-03-01,0,0,1,0,0,0,DOM
2020-03-01,0,0,4,0,0,0,DZA
2020-03-01,10,2,3,0,0,10,ECU
2020-03-01,179,6,0,5,0,184,EGY
2020-03-01,0,0,3,1,0,1,ERI
2020-03-01,0,0,1,1,0,1,ESH
2020-03-01,3,8,0,5,0,8,ESP
2020-03-01,0,0,0,1,0,1,EST
2020-03-01,0,0,0,50,5,50,FIN
2020-03-01,0,0,1,0,0,0,FJI
2020-03-01,0,0,5,23,0,23,FRA
2020-03-01,119,0,1,0,0,119,GAB
2020-03-01,160,14,3,18,2311,178,GBR
2020-03-01,1,0,0,0,0,1,GEO
2020-03-01,4,0,7,1,0,5,GHA
2020-03-01,0,0,3,1,0,1,GIN
2020-03-01,0,0,2,9,0,9,GNB
2020-03-01,14,0,0,0,0,14,GNQ
2020-03-01,5,0,0,2,0,7,GRC
2020-03-01,0,0,2,0,0,0,GUY
2020-03-01,16,0,0,3,0,19,HRV
2020-03-01,577,77,71,187,0,764,IDN
2020-03-01,191,6,33,26,0,217,IND
2020-03-01,3,0,1,3,7,6,IRL
2020-03-01,162,2,0,0,0,162,IRN
2020-03-01,1,1,0,7,0,8,IRQ
2020-03-01,0,0,0,2,0,2,ISL
2020-03-01,3,0,2,0,0,3,ISR
2020-03-01,103,9,3,6,0,109,ITA
2020-03-01,0,0,0,1,0,1,JAM
2020-03-01,0,0,0,5,0,5,JEY
2020-03-01,19,12,46,37,0,56,JPN
2020-03-01,0,0,4,0,0,0,KEN
2020-03-01,3,0,2,2,0,5,KHM
2020-03-01,5,0,62,74,12,79,KOR
2020-03-01,34,3,0,37,0,71,KWT
2020-03-01,0,0,12,3,0,3,LBR
2020-03-01,9,0,1,0,0,9,LBY
2020-03-01,0,0,5,5,0,5,LKA
2020-03-01,1,0,0,0,0,1,LTU
2020-03-01,0,0,1,0,0,0,LVA
2020-03-01,0,0,0,2,0,2,MAR
2020-03-01,0,0,1,0,0,0,MDG
2020-03-01,202,3,15,2,0,204,MEX
2020-03-01,4,5,18,13,0,17,MMR
2020-03-01,0,0,1,0,0,0,MNP
2020-03-01,0,0,1,3,0,3,MOZ
2020-03-01,1,0,1,0,0,1,MRT
2020-03-01,346,62,73,79,0,425,MYS
2020-03-01,9,1,0,0,0,9,NAM
2020-03-01,435,4,1,2,0,437,NGA
2020-03-01,0,0,2,1,0,1,NIC
2020-03-01,113,13,1,6,371,119,NLD
2020-03-01,20,0,0,5,2,25,NOR
2020-03-01,7,0,1,6,0,13,NZL
2020-03-01,19,0,13,5,0,24,None
2020-03-01,8,0,2,2,0,10,OMN
2020-03-01,0,0,2,0,0,0,PAK
2020-03-01,0,2,6,4,0,4,PAN
2020-03-01,100,1,3,2,0,102,PER
2020-03-01,8,0,10,67,0,75,PHL
2020-03-01,2,0,1,3,0,5,PNG
2020-03-01,9,3,0,5,3,14,POL
2020-03-01,0,0,2,4,0,4,PRK
2020-03-01,0,0,1,0,0,0,PRT
2020-03-01,166,0,5,2,0,168,QAT
2020-03-01,8,0,0,0,0,8,ROU
2020-03-01,8,1,6,4,0,12,RUS
2020-03-01,720,27,9,2,0,722,SAU
2020-03-01,1,0,2,0,0,1,SDN
2020-03-01,3,0,0,0,0,3,SEN
2020-03-01,0,0,0,31,0,31,SGP
2020-03-01,0,0,1,0,0,0,SLB
2020-03-01,0,0,1,4,0,4,SLE
2020-03-01,0,0,0,1,0,1,SLV
2020-03-01,0,0,1,1,0,1,SOM
2020-03-01,1,1,0,0,0,1,SUR
2020-03-01,0,0,2,48,65,48,SWE
2020-03-01,3,0,0,0,0,3,TGO
2020-03-01,413,2,23,199,0,612,THA
2020-03-01,3,0,0,0,0,3,TLS
2020-03-01,332,2,0,1,0,333,TTO
2020-03-01,14,14,1,0,0,14,TUN
2020-03-01,6,1,13,48,0,54,TUR
2020-03-01,7,8,2,0,22,7,TWN
2020-03-01,1,1,0,0,0,1,TZA
2020-03-01,14,5,3,15,0,29,UKR
2020-03-01,0,0,1,0,0,0,URY
2020-03-01,2214,49,1,653,5,2867,USA
2020-03-01,11,3,3,5,0,16,VEN
2020-03-01,1,0,0,0,0,1,VIR
2020-03-01,43,4,21,240,30,283,VNM
2020-03-01,0,0,1,0,0,0,VUT
2020-03-01,3,0,8,2,0,5,YEM
2020-03-01,1,0,4,1,0,2,ZAF
2020-04-01,1,0,1,0,0,1,ABW
2020-04-01,248,1,1,0,0,248,AGO
2020-04-01,522,2,2,16,0,538,ARE
2020-04-01,0,0,1,0,0,0,ASM
2020-04-01,0,0,1,0,0,0,ATG
2020-04-01,73,5,33,54,0,127,AUS
2020-04-01,0,0,1,5,405,5,BEL
2020-04-01,6,0,0,0,0,6,BEN
2020-04-01,0,0,1,0,0,0,BES
2020-04-01,2,3,0,0,0,2,BGD
2020-04-01,1,0,0,0,0,1,BGR
2020-04-01,3,0,1,0,0,3,BHR
2020-04-01,0,0,4,5,0,5,BHS
2020-04-01,139,19,7,40,0,179,BRA
2020-04-01,128,4,0,0,0,128,BRN
2020-04-01,6,0,8,27,0,33,CAN
2020-04-01,0,0,2,0,0,0,CHL
2020-04-01,313,68,143,438,2275,751,CHN
2020-04-01,11,1,1,0,0,11,CIV
2020-04-01,77,0,0,0,0,77,CMR
2020-04-01,49,0,0,0,0,49,COD
2020-04-01,77,0,0,0,0,77,COG
2020-04-01,5,0,1,3,0,8,COL
2020-04-01,3,0,5,2,0,5,CUB
2020-04-01,0,0,1,0,0,0,CYP
2020-04-01,19,17,2,29,1504,48,DEU
2020-04-01,0,0,1,0,0,0,DJI
2020-04-01,15,2,0,19,513,34,DNK
2020-04-01,0,0,1,0,0,0,DOM
2020-04-01,0,0,4,0,0,0,DZA
2020-04-01,10,2,3,0,0,10,ECU
2020-04-01,177,6,0,5,0,182,EGY
2020-04-01,0,0,4,1,0,1,ERI
2020-04-01,0,0,1,1,0,1,ESH
2020-04-01,3,9,0,5,0,8,ESP
2020-04-01,0,0,0,1,0,1,EST
2020-04-01,0,0,0,50,5,50,FIN
2020-04-01,0,0,1,0,0,0,FJI
2020-04-01,0,0,5,26,0,26,FRA
2020-04-01,123,0,1,0,0,123,GAB
2020-04-01,165,15,3,16,2319,181,GBR
2020-04-01,1,0,0,0,0,1,GEO
2020-04-01,4,0,5,1,0,5,GHA
2020-04-01,0,0,3,1,0,1,GIN
2020-04-01,0,0,1,9,0,9,GNB
2020-04-01,13,0,0,0,0,13,GNQ
2020-04-01,5,1,0,2,0,7,GRC
2020-04-01,0,0,1,0,0,0,GUY
2020-04-01,16,0,0,3,0,19,HRV
2020-04-01,585,94,80,187,0,772,IDN
2020-04-01,187,5,35,29,0,216,IND
2020-04-01,3,0,1,4,7,7,IRL
2020-04-01,164,2,0,1,0,165,IRN
2020-04-01,1,1,0,8,0,9,IRQ
2020-04-01,0,0,0,2,0,2,ISL
2020-04-01,3,0,1,0,0,3,ISR
2020-04-01,103,10,3,7,0,110,ITA
2020-04-01,0,0,1,1,0,1,JAM
2020-04-01,0,0,0,2,0,2,JEY
2020-04-01,19,13,45,45,0,64,JPN
2020-04-01,0,0,4,2,0,2,KEN
2020-04-01,3,0,2,5,0,8,KHM
2020-04-01,5,0,64,69,12,74,KOR
2020-04-01,35,3,0,40,0,75,KWT
2020-04-01,0,0,12,3,0,3,LBR
2020-04-01,9,0,1,0,0,9,LBY
2020-04-01,0,0,6,5,0,5,LKA
2020-04-01,1,0,0,0,0,1,LTU
2020-04-01,0,0,1,0,0,0,LVA
2020-04-01,0,0,0,2,0,2,MAR
2020-04-01,0,0,1,0,0,0,MDG
2020-04-01,202,3,14,3,0,205,MEX
2020-04-01,4,5,18,13,0,17,MMR
2020-04-01,0,0,1,0,0,0,MNP
2020-04-01,2,0,1,3,0,5,MOZ
2020-04-01,0,0,1,0,0,0,MRT
2020-04-01,344,79,72,87,0,431,MYS
2020-04-01,10,1,0,0,0,10,NAM
2020-04-01,433,4,3,2,0,435,NGA
2020-04-01,0,0,2,1,0,1,NIC
2020-04-01,112,12,1,7,426,119,NLD
2020-04-01,14,0,0,5,2,19,NOR
2020-04-01,8,0,1,7,0,15,NZL
2020-04-01,18,0,16,7,0,25,None
2020-04-01,8,0,3,1,0,9,OMN
2020-04-01,0,0,3,0,0,0,PAK
2020-04-01,0,2,5,4,0,4,PAN
2020-04-01,100,2,4,2,0,102,PER
2020-04-01,8,0,9,71,0,79,PHL
2020-04-01,2,0,1,3,0,5,PNG
2020-04-01,8,4,0,5,3,13,POL
2020-04-01,0,0,3,3,0,3,PRK
2020-04-01,0,0,1,0,0,0,PRT
2020-04-01,168,0,3,3,0,171,QAT
2020-04-01,8,0,0,0,0,8,ROU
2020-04-01,9,1,6,4,0,13,RUS
2020-04-01,720,27,9,2,0,722,SAU
2020-04-01,1,0,2,0,0,1,SDN
2020-04-01,3,0,0,0,0,3,SEN
2020-04-01,0,0,0,36,0,36,SGP
2020-04-01,0,0,1,0,0,0,SLB
2020-04-01,0,0,2,6,0,6,SLE
2020-04-01,0,0,0,1,0,1,SOM
2020-04-01,1,0,0,0,0,1,SUR
2020-04-01,0,0,2,50,65,50,SWE
2020-04-01,3,0,0,0,0,3,TGO
2020-04-01,418,2,24,221,0,639,THA
2020-04-01,3,0,0,0,0,3,TLS
2020-04-01,338,2,0,1,0,339,TTO
2020-04-01,14,14,1,1,0,15,TUN
2020-04-01,5,1,14,46,0,51,TUR
2020-04-01,7,8,2,0,22,7,TWN
2020-04-01,1,1,0,0,0,1,TZA
2020-04-01,14,4,3,14,0,28,UKR
2020-04-01,0,0,1,0,0,0,URY
2020-04-01,2243,51,2,701,5,2944,USA
2020-04-01,12,3,3,8,0,20,VEN
2020-04-01,1,0,0,0,0,1,VIR
2020-04-01,44,3,20,260,34,304,VNM
2020-04-01,0,0,1,0,0,0,VUT
2020-04-01,2,0,9,1,0,3,YEM
2020-04-01,1,0,4,1,0,2,ZAF
2020-05-01,0,0,1,0,0,0,ABW
2020-05-01,243,2,1,0,0,243,AGO
2020-05-01,517,2,2,21,0,538,ARE
2020-05-01,0,0,1,0,0,0,ASM
2020-05-01,0,0,1,0,0,0,ATG
2020-05-01,73,5,31,57,0,130,AUS
2020-05-01,0,0,1,5,405,5,BEL
2020-05-01,6,0,0,0,0,6,BEN
2020-05-01,0,0,1,0,0,0,BES
2020-05-01,2,3,0,0,0,2,BGD
2020-05-01,1,0,0,0,0,1,BGR
2020-05-01,3,1,1,0,0,3,BHR
2020-05-01,0,0,4,5,0,5,BHS
2020-05-01,136,23,8,42,0,178,BRA
2020-05-01,127,5,0,0,0,127,BRN
2020-05-01,6,0,7,31,0,37,CAN
2020-05-01,0,0,2,0,0,0,CHL
2020-05-01,314,64,137,428,2360,742,CHN
2020-05-01,11,1,1,0,0,11,CIV
2020-05-01,77,0,0,0,0,77,CMR
2020-05-01,49,0,0,0,0,49,COD
2020-05-01,76,0,0,0,0,76,COG
2020-05-01,5,0,1,3,0,8,COL
2020-05-01,3,0,5,3,0,6,CUB
2020-05-01,0,0,2,0,0,0,CYP
2020-05-01,20,17,2,30,1503,50,DEU
2020-05-01,0,0,1,0,0,0,DJI
2020-05-01,17,2,1,21,512,38,DNK
2020-05-01,0,0,1,0,0,0,DOM
2020-05-01,0,0,4,0,0,0,DZA
2020-05-01,11,2,3,1,0,12,ECU
2020-05-01,180,6,0,5,0,185,EGY
2020-05-01,0,0,4,1,0,1,ERI
2020-05-01,0,0,1,0,0,0,ESH
2020-05-01,3,9,0,5,0,8,ESP
2020-05-01,0,0,0,1,0,1,EST
2020-05-01,0,0,0,51,5,51,FIN
2020-05-01,0,0,1,0,0,0,FJI
2020-05-01,0,0,5,26,0,26,FRA
2020-05-01,122,0,1,0,0,122,GAB
2020-05-01,171,14,3,15,2324,186,GBR
2020-05-01,1,0,0,0,0,1,GEO
2020-05-01,4,0,6,1,0,5,GHA
2020-05-01,0,0,3,1,0,1,GIN
2020-05-01,0,0,2,8,0,8,GNB
2020-05-01,7,0,0,0,0,7,GNQ
2020-05-01,5,1,0,2,0,7,GRC
2020-05-01,16,0,0,3,0,19,HRV
2020-05-01,589,92,79,186,0,775,IDN
2020-05-01,190,3,40,37,0,227,IND
2020-05-01,3,0,1,5,7,8,IRL
2020-05-01,167,3,0,1,0,168,IRN
2020-05-01,1,1,0,10,0,11,IRQ
2020-05-01,0,0,0,2,0,2,ISL
2020-05-01,3,0,2,0,0,3,ISR
2020-05-01,103,10,3,7,0,110,ITA
2020-05-01,0,0,1,2,0,2,JAM
2020-05-01,0,0,0,2,0,2,JEY
2020-05-01,20,13,43,46,0,66,JPN
2020-05-01,0,0,4,3,0,3,KEN
2020-05-01,3,0,1,5,0,8,KHM
2020-05-01,5,0,67,77,12,82,KOR
2020-05-01,32,2,0,41,0,73,KWT
2020-05-01,0,0,10,3,0,3,LBR
2020-05-01,9,0,1,0,0,9,LBY
2020-05-01,0,0,6,5,0,5,LKA
2020-05-01,1,0,0,0,0,1,LTU
2020-05-01,0,0,1,0,0,0,LVA
2020-05-01,0,0,0,3,0,3,MAR
2020-05-01,0,0,1,0,0,0,MDG
2020-05-01,202,3,15,4,0,206,MEX
2020-05-01,4,4,18,13,0,17,MMR
2020-05-01,0,0,1,0,0,0,MNP
2020-05-01,2,1,0,3,0,5,MOZ
2020-05-01,0,0,1,0,0,0,MRT
2020-05-01,344,83,68,88,0,432,MYS
2020-05-01,8,1,0,0,0,8,NAM
2020-05-01,0,0,1,0,0,0,NCL
2020-05-01,431,4,3,1,0,432,NGA
2020-05-01,0,0,2,2,0,2,NIC
2020-05-01,114,14,1,8,448,122,NLD
2020-05-01,14,0,0,5,2,19,NOR
2020-05-01,8,0,1,6,0,14,NZL
2020-05-01,19,0,19,7,0,26,None
2020-05-01,8,0,3,2,0,10,OMN
2020-05-01,0,0,3,0,0,0,PAK
2020-05-01,0,1,5,2,0,2,PAN
2020-05-01,102,2,4,4,0,106,PER
2020-05-01,8,0,10,80,0,88,PHL
2020-05-01,2,0,1,3,0,5,PNG
2020-05-01,8,4,0,5,3,13,POL
2020-05-01,0,0,3,4,0,4,PRK
2020-05-01,0,0,1,1,0,1,PRT
2020-05-01,169,0,3,4,0,173,QAT
2020-05-01,8,0,0,0,0,8,ROU
2020-05-01,10,1,8,4,0,14,RUS
2020-05-01,722,28,9,1,0,723,SAU
2020-05-01,1,0,2,0,0,1,SDN
2020-05-01,1,0,0,0,0,1,SEN
2020-05-01,0,0,0,39,0,39,SGP
2020-05-01,0,0,1,0,0,0,SLB
2020-05-01,0,0,2,6,0,6,SLE
2020-05-01,0,0,0,1,0,1,SOM
2020-05-01,1,0,0,0,0,1,SUR
2020-05-01,0,0,1,50,65,50,SWE
2020-05-01,3,0,0,0,0,3,TGO
2020-05-01,416,2,24,200,0,616,THA
2020-05-01,3,0,0,0,0,3,TLS
2020-05-01,341,2,0,1,0,342,TTO
2020-05-01,13,14,1,1,0,14,TUN
2020-05-01,5,1,14,49,0,54,TUR
2020-05-01,7,5,2,0,22,7,TWN
2020-05-01,1,1,0,0,0,1,TZA
2020-05-01,14,4,3,16,0,30,UKR
2020-05-01,0,0,1,0,0,0,URY
2020-05-01,2238,49,2,712,5,2950,USA
2020-05-01,12,3,4,8,0,20,VEN
2020-05-01,43,2,21,256,47,299,VNM
2020-05-01,0,0,1,0,0,0,VUT
2020-05-01,2,0,9,0,0,2,YEM
2020-05-01,1,0,5,1,0,2,ZAF
2020-06-01,0,0,1,0,0,0,ABW
2020-06-01,244,2,1,0,0,244,AGO
2020-06-01,518,2,3,17,0,535,ARE
2020-06-01,0,0,1,0,0,0,ASM
2020-06-01,0,0,1,0,0,0,ATG
2020-06-01,72,4,29,60,0,132,AUS
2020-06-01,0,0,1,5,405,5,BEL
2020-06-01,6,0,0,0,0,6,BEN
2020-06-01,0,0,1,0,0,0,BES
2020-06-01,2,3,0,0,0,2,BGD
2020-06-01,1,0,0,0,0,1,BGR
2020-06-01,3,1,1,0,0,3,BHR
2020-06-01,0,0,5,5,0,5,BHS
2020-06-01,136,23,9,45,0,181,BRA
2020-06-01,127,5,0,0,0,127,BRN
2020-06-01,6,0,6,33,0,39,CAN
2020-06-01,0,0,2,0,0,0,CHL
2020-06-01,317,64,133,426,2514,743,CHN
2020-06-01,11,1,1,0,0,11,CIV
2020-06-01,77,0,0,0,0,77,CMR
2020-06-01,50,0,0,0,0,50,COD
2020-06-01,77,0,0,0,0,77,COG
2020-06-01,5,0,2,3,0,8,COL
2020-06-01,3,0,5,3,0,6,CUB
2020-06-01,0,0,2,0,0,0,CYP
2020-06-01,21,18,2,30,1503,51,DEU
2020-06-01,0,0,1,0,0,0,DJI
2020-06-01,18,2,1,21,523,39,DNK
2020-06-01,0,0,1,0,0,0,DOM
2020-06-01,0,0,4,1,0,1,DZA
2020-06-01,11,2,3,2,0,13,ECU
2020-06-01,183,5,2,6,0,189,EGY
2020-06-01,0,0,3,1,0,1,ERI
2020-06-01,0,0,1,0,0,0,ESH
2020-06-01,3,9,0,5,0,8,ESP
2020-06-01,0,0,0,2,0,2,EST
2020-06-01,0,0,0,51,5,51,FIN
2020-06-01,0,0,5,29,0,29,FRA
2020-06-01,123,0,1,0,0,123,GAB
2020-06-01,171,14,3,17,2335,188,GBR
2020-06-01,1,0,0,0,0,1,GEO
2020-06-01,0,0,0,1,0,1,GGY
2020-06-01,4,0,7,1,0,5,GHA
2020-06-01,0,0,2,0,0,0,GIN
2020-06-01,0,0,2,6,0,6,GNB
2020-06-01,7,0,0,0,0,7,GNQ
2020-06-01,5,1,0,2,0,7,GRC
2020-06-01,0,0,1,0,0,0,GUF
2020-06-01,16,0,0,3,0,19,HRV
2020-06-01,588,99,83,182,0,770,IDN
2020-06-01,191,3,43,37,0,228,IND
2020-06-01,3,0,1,4,7,7,IRL
2020-06-01,167,5,0,1,0,168,IRN
2020-06-01,1,1,0,11,0,12,IRQ
2020-06-01,0,0,0,2,0,2,ISL
2020-06-01,3,0,2,0,0,3,ISR
2020-06-01,103,9,3,6,0,109,ITA
2020-06-01,0,0,1,2,0,2,JAM
2020-06-01,0,0,0,2,0,2,JEY
2020-06-01,19,12,43,54,0,73,JPN
2020-06-01,0,0,3,3,0,3,KEN
2020-06-01,3,0,1,5,0,8,KHM
2020-06-01,5,0,63,72,12,77,KOR
2020-06-01,32,1,0,44,0,76,KWT
2020-06-01,0,0,9,2,0,2,LBR
2020-06-01,10,0,1,0,0,10,LBY
2020-06-01,0,0,6,5,0,5,LKA
2020-06-01,1,0,0,0,0,1,LTU
2020-06-01,0,0,1,1,0,1,LVA
2020-06-01,0,0,0,3,0,3,MAR
2020-06-01,0,0,1,0,0,0,MDG
2020-06-01,207,2,14,4,0,211,MEX
2020-06-01,4,4,18,12,0,16,MMR
2020-06-01,0,0,1,0,0,0,MNP
2020-06-01,1,1,0,2,0,3,MOZ
2020-06-01,0,0,1,0,0,0,MRT
2020-06-01,346,76,64,83,0,429,MYS
2020-06-01,10,1,0,0,0,10,NAM
2020-06-01,0,0,1,0,0,0,NCL
2020-06-01,424,4,3,1,0,425,NGA
2020-06-01,0,0,2,2,0,2,NIC
2020-06-01,114,14,1,9,461,123,NLD
2020-06-01,15,0,0,6,2,21,NOR
2020-06-01,8,0,1,6,0,14,NZL
2020-06-01,19,0,20,8,0,27,None
2020-06-01,8,0,3,2,0,10,OMN
2020-06-01,0,0,3,0,0,0,PAK
2020-06-01,0,0,5,3,0,3,PAN
2020-06-01,102,2,4,3,0,105,PER
2020-06-01,7,0,10,81,0,88,PHL
2020-06-01,2,0,2,3,0,5,PNG
2020-06-01,8,3,0,6,3,14,POL
2020-06-01,0,0,2,3,0,3,PRK
2020-06-01,0,0,1,1,0,1,PRT
2020-06-01,168,0,3,4,0,172,QAT
2020-06-01,8,0,0,0,0,8,ROU
2020-06-01,11,1,8,5,0,16,RUS
2020-06-01,718,30,9,1,0,719,SAU
2020-06-01,1,0,2,0,0,1,SDN
2020-06-01,0,0,0,39,0,39,SGP
2020-06-01,0,0,1,0,0,0,SLB
2020-06-01,0,0,1,6,0,6,SLE
2020-06-01,0,0,0,1,0,1,SOM
2020-06-01,1,0,1,0,0,1,SUR
2020-06-01,0,0,1,50,65,50,SWE
2020-06-01,0,0,1,0,0,0,SYR
2020-06-01,4,0,0,0,0,4,TGO
2020-06-01,414,1,24,189,0,603,THA
2020-06-01,3,0,0,0,0,3,TLS
2020-06-01,342,1,0,1,0,343,TTO
2020-06-01,13,14,1,0,0,13,TUN
2020-06-01,5,1,15,49,0,54,TUR
2020-06-01,7,7,2,0,22,7,TWN
2020-06-01,1,1,0,0,0,1,TZA
2020-06-01,14,4,3,13,0,27,UKR
2020-06-01,0,0,1,0,0,0,URY
2020-06-01,2229,47,3,686,7,2915,USA
2020-06-01,13,4,4,8,0,21,VEN
2020-06-01,45,2,20,263,56,308,VNM
2020-06-01,0,0,1,0,0,0,VUT
2020-06-01,2,0,8,0,0,2,YEM
2020-06-01,1,0,5,1,0,2,ZAF
2020-07-01,0,0,1,0,0,0,ABW
2020-07-01,245,2,0,0,0,245,AGO
2020-07-01,518,1,4,11,0,529,ARE
2020-07-01,0,0,1,0,0,0,ASM
2020-07-01,0,0,1,0,0,0,ATG
2020-07-01,71,5,32,59,0,130,AUS
2020-07-01,0,0,1,5,405,5,BEL
2020-07-01,6,0,0,0,0,6,BEN
2020-07-01,0,0,1,0,0,0,BES
2020-07-01,2,3,0,0,0,2,BGD
2020-07-01,1,0,0,0,0,1,BGR
2020-07-01,3,1,1,0,0,3,BHR
2020-07-01,0,0,4,6,0,6,BHS
2020-07-01,137,24,9,44,0,181,BRA
2020-07-01,128,4,0,0,0,128,BRN
2020-07-01,4,0,7,34,0,38,CAN
2020-07-01,0,0,1,0,0,0,CHL
2020-07-01,313,63,138,442,2655,755,CHN
2020-07-01,12,1,1,0,0,12,CIV
2020-07-01,77,0,0,0,0,77,CMR
2020-07-01,50,0,0,0,0,50,COD
2020-07-01,79,0,0,0,0,79,COG
2020-07-01,5,0,2,3,0,8,COL
2020-07-01,3,0,5,3,0,6,CUB
2020-07-01,0,0,2,0,0,0,CYP
2020-07-01,21,17,2,30,1504,51,DEU
2020-07-01,0,0,1,0,0,0,DJI
2020-07-01,19,2,1,21,536,40,DNK
2020-07-01,0,0,1,0,0,0,DOM
2020-07-01,0,0,4,1,0,1,DZA
2020-07-01,11,2,3,2,0,13,ECU
2020-07-01,184,6,2,6,0,190,EGY
2020-07-01,0,0,3,1,0,1,ERI
2020-07-01,0,0,1,0,0,0,ESH
2020-07-01,3,9,0,5,0,8,ESP
2020-07-01,0,0,0,2,0,2,EST
2020-07-01,0,0,0,49,5,49,FIN
2020-07-01,0,0,4,31,0,31,FRA
2020-07-01,124,0,1,0,0,124,GAB
2020-07-01,166,14,3,17,2339,183,GBR
2020-07-01,1,0,0,0,0,1,GEO
2020-07-01,0,0,0,1,0,1,GGY
2020-07-01,4,0,8,2,0,6,GHA
2020-07-01,0,0,2,1,0,1,GIN
2020-07-01,0,0,2,6,0,6,GNB
2020-07-01,7,0,0,0,0,7,GNQ
2020-07-01,5,0,0,4,0,9,GRC
2020-07-01,0,0,1,0,0,0,GUF
2020-07-01,0,0,0,1,0,1,GUY
2020-07-01,16,0,0,3,0,19,HRV
2020-07-01,590,105,86,189,0,779,IDN
2020-07-01,187,3,41,35,0,222,IND
2020-07-01,3,0,1,3,7,6,IRL
2020-07-01,170,6,0,1,0,171,IRN
2020-07-01,2,1,0,8,0,10,IRQ
2020-07-01,0,0,0,2,0,2,ISL
2020-07-01,3,0,2,0,0,3,ISR
2020-07-01,105,9,3,6,0,111,ITA
2020-07-01,0,0,1,1,0,1,JAM
2020-07-01,0,0,0,3,0,3,JEY
2020-07-01,19,12,43,52,0,71,JPN
2020-07-01,0,0,3,3,0,3,KEN
2020-07-01,3,0,1,4,0,7,KHM
2020-07-01,6,0,61,70,12,76,KOR
2020-07-01,34,2,0,47,0,81,KWT
2020-07-01,0,0,9,2,0,2,LBR
2020-07-01,10,0,1,0,0,10,LBY
2020-07-01,0,0,5,5,0,5,LKA
2020-07-01,1,0,0,0,0,1,LTU
2020-07-01,0,0,1,1,0,1,LVA
2020-07-01,0,0,0,2,0,2,MAR
2020-07-01,0,0,1,0,0,0,MDG
2020-07-01,205,1,14,4,0,209,MEX
2020-07-01,4,4,17,10,0,14,MMR
2020-07-01,1,0,0,2,0,3,MOZ
2020-07-01,0,0,1,0,0,0,MRT
2020-07-01,343,77,65,88,0,431,MYS
2020-07-01,12,1,0,0,0,12,NAM
2020-07-01,0,0,1,0,0,0,NCL
2020-07-01,430,4,5,1,0,431,NGA
2020-07-01,0,0,2,2,0,2,NIC
2020-07-01,113,15,1,9,466,122,NLD
2020-07-01,17,0,0,6,2,23,NOR
2020-07-01,8,0,1,7,0,15,NZL
2020-07-01,16,0,18,8,0,24,None
2020-07-01,8,0,3,1,0,9,OMN
2020-07-01,0,0,2,0,0,0,PAK
2020-07-01,0,0,6,3,0,3,PAN
2020-07-01,101,2,3,3,0,104,PER
2020-07-01,7,0,10,72,0,79,PHL
2020-07-01,2,0,4,3,0,5,PNG
2020-07-01,8,3,0,6,3,14,POL
2020-07-01,0,0,1,3,0,3,PRK
2020-07-01,0,0,1,0,0,0,PRT
2020-07-01,171,0,3,2,0,173,QAT
2020-07-01,8,0,0,0,0,8,ROU
2020-07-01,8,2,6,7,0,15,RUS
2020-07-01,722,31,9,1,0,723,SAU
2020-07-01,1,1,2,0,0,1,SDN
2020-07-01,0,0,0,27,0,27,SGP
2020-07-01,0,0,1,0,0,0,SLB
2020-07-01,0,0,1,6,0,6,SLE
2020-07-01,0,0,0,1,0,1,SOM
2020-07-01,1,0,1,0,0,1,SUR
2020-07-01,0,0,1,51,65,51,SWE
2020-07-01,0,0,1,0,0,0,SYR
2020-07-01,4,0,0,0,0,4,TGO
2020-07-01,415,1,23,184,0,599,THA
2020-07-01,3,0,0,0,0,3,TLS
2020-07-01,344,1,0,1,0,345,TTO
2020-07-01,14,14,1,0,0,14,TUN
2020-07-01,5,1,16,49,0,54,TUR
2020-07-01,7,7,3,1,22,8,TWN
2020-07-01,1,1,0,0,0,1,TZA
2020-07-01,13,5,3,13,0,26,UKR
2020-07-01,0,0,1,0,0,0,URY
2020-07-01,2191,47,3,658,7,2849,USA
2020-07-01,13,4,4,7,0,20,VEN
2020-07-01,46,2,22,274,54,320,VNM
2020-07-01,0,0,1,0,0,0,VUT
2020-07-01,3,0,8,0,0,3,YEM
2020-07-01,1,0,4,1,0,2,ZAF
2020-08-01,1,0,1,0,0,1,ABW
2020-08-01,249,2,0,0,0,249,AGO
2020-08-01,521,1,3,12,0,533,ARE
2020-08-01,0,0,1,0,0,0,ASM
2020-08-01,0,0,1,0,0,0,ATG
2020-08-01,72,6,33,60,0,132,AUS
2020-08-01,0,0,1,5,405,5,BEL
2020-08-01,6,0,0,0,0,6,BEN
2020-08-01,0,0,1,0,0,0,BES
2020-08-01,2,3,1,0,0,2,BGD
2020-08-01,1,0,0,0,0,1,BGR
2020-08-01,7,0,1,0,0,7,BHR
2020-08-01,0,0,4,6,0,6,BHS
2020-08-01,140,24,9,39,0,179,BRA
2020-08-01,127,4,0,0,0,127,BRN
2020-08-01,3,0,7,33,0,36,CAN
2020-08-01,318,64,134,441,2811,759,CHN
2020-08-01,12,1,1,0,0,12,CIV
2020-08-01,75,0,0,0,0,75,CMR
2020-08-01,49,0,0,0,0,49,COD
2020-08-01,78,0,0,0,0,78,COG
2020-08-01,5,0,2,3,0,8,COL
2020-08-01,3,0,5,4,0,7,CUB
2020-08-01,0,0,1,0,0,0,CYP
2020-08-01,21,17,2,29,1500,50,DEU
2020-08-01,0,0,1,0,0,0,DJI
2020-08-01,20,2,1,21,559,41,DNK
2020-08-01,0,0,1,0,0,0,DOM
2020-08-01,0,0,5,0,0,0,DZA
2020-08-01,11,1,3,2,0,13,ECU
2020-08-01,182,6,1,5,0,187,EGY
2020-08-01,0,0,2,0,0,0,ERI
2020-08-01,3,8,0,5,0,8,ESP
2020-08-01,0,0,0,2,0,2,EST
2020-08-01,0,0,0,49,5,49,FIN
2020-08-01,0,0,4,29,0,29,FRA
2020-08-01,122,0,1,0,0,122,GAB
2020-08-01,159,12,3,16,2399,175,GBR
2020-08-01,1,0,0,0,0,1,GEO
2020-08-01,0,0,0,1,0,1,GGY
2020-08-01,4,0,8,2,0,6,GHA
2020-08-01,0,0,1,2,0,2,GIN
2020-08-01,0,0,3,7,0,7,GNB
2020-08-01,7,0,0,0,0,7,GNQ
2020-08-01,5,0,0,4,0,9,GRC
2020-08-01,0,0,1,0,0,0,GUF
2020-08-01,0,0,0,1,0,1,GUY
2020-08-01,16,0,0,3,0,19,HRV
2020-08-01,596,102,85,199,0,795,IDN
2020-08-01,189,2,42,23,0,212,IND
2020-08-01,3,0,1,3,7,6,IRL
2020-08-01,168,5,0,1,0,169,IRN
2020-08-01,2,2,0,8,0,10,IRQ
2020-08-01,0,0,0,2,0,2,ISL
2020-08-01,4,0,2,0,0,4,ISR
2020-08-01,105,9,3,7,0,112,ITA
2020-08-01,0,0,1,1,0,1,JAM
2020-08-01,0,0,0,3,0,3,JEY
2020-08-01,17,12,43,48,0,65,JPN
2020-08-01,0,0,3,2,0,2,KEN
2020-08-01,3,0,1,6,0,9,KHM
2020-08-01,6,0,62,70,12,76,KOR
2020-08-01,32,2,0,42,0,74,KWT
2020-08-01,0,0,8,2,0,2,LBR
2020-08-01,11,0,1,0,0,11,LBY
2020-08-01,0,0,4,3,0,3,LKA
2020-08-01,1,0,0,0,0,1,LTU
2020-08-01,0,0,1,0,0,0,LVA
2020-08-01,0,0,0,2,0,2,MAR
2020-08-01,0,0,1,0,0,0,MDG
2020-08-01,203,2,15,3,0,206,MEX
2020-08-01,4,4,16,9,0,13,MMR
2020-08-01,1,0,1,2,0,3,MOZ
2020-08-01,0,0,1,0,0,0,MRT
2020-08-01,343,76,79,78,0,421,MYS
2020-08-01,14,1,0,0,0,14,NAM
2020-08-01,0,0,1,0,0,0,NCL
2020-08-01,429,3,6,1,0,430,NGA
2020-08-01,0,0,2,2,0,2,NIC
2020-08-01,116,15,1,10,466,126,NLD
2020-08-01,18,0,0,7,1,25,NOR
2020-08-01,8,0,1,7,0,15,NZL
2020-08-01,15,0,21,9,0,24,None
2020-08-01,8,0,1,1,0,9,OMN
2020-08-01,0,0,1,0,0,0,PAK
2020-08-01,0,0,5,3,0,3,PAN
2020-08-01,100,1,3,2,0,102,PER
2020-08-01,7,0,8,64,0,71,PHL
2020-08-01,2,0,3,3,0,5,PNG
2020-08-01,8,3,0,5,3,13,POL
2020-08-01,0,0,1,5,0,5,PRK
2020-08-01,0,0,1,0,0,0,PRT
2020-08-01,173,0,2,2,0,175,QAT
2020-08-01,8,1,0,0,0,8,ROU
2020-08-01,8,2,7,10,0,18,RUS
2020-08-01,722,32,9,2,0,724,SAU
2020-08-01,1,1,2,0,0,1,SDN
2020-08-01,0,0,0,30,0,30,SGP
2020-08-01,0,0,1,0,0,0,SLB
2020-08-01,0,0,1,5,0,5,SLE
2020-08-01,0,0,0,1,0,1,SOM
2020-08-01,1,0,1,0,0,1,SUR
2020-08-01,0,0,1,51,65,51,SWE
2020-08-01,4,0,0,0,0,4,TGO
2020-08-01,416,1,25,166,0,582,THA
2020-08-01,3,0,0,0,0,3,TLS
2020-08-01,343,1,1,1,0,344,TTO
2020-08-01,14,14,1,1,0,15,TUN
2020-08-01,5,0,17,49,0,54,TUR
2020-08-01,7,8,4,1,24,8,TWN
2020-08-01,1,0,0,0,0,1,TZA
2020-08-01,13,5,3,13,0,26,UKR
2020-08-01,0,0,1,0,0,0,URY
2020-08-01,2152,47,2,656,7,2808,USA
2020-08-01,12,4,3,6,0,18,VEN
2020-08-01,45,2,21,277,25,322,VNM
2020-08-01,0,0,1,0,0,0,VUT
2020-08-01,3,0,8,0,0,3,YEM
2020-08-01,1,0,4,1,0,2,ZAF
2020-09-01,2,0,1,0,0,2,ABW
2020-09-01,246,3,0,0,0,246,AGO
2020-09-01,523,1,2,10,0,533,ARE
2020-09-01,0,0,1,0,0,0,ASM
2020-09-01,0,0,1,0,0,0,ATG
2020-09-01,72,6,34,65,0,137,AUS
2020-09-01,0,0,1,5,405,5,BEL
2020-09-01,6,0,0,0,0,6,BEN
2020-09-01,0,0,1,0,0,0,BES
2020-09-01,2,2,1,0,0,2,BGD
2020-09-01,1,0,0,0,0,1,BGR
2020-09-01,7,1,1,0,0,7,BHR
2020-09-01,0,0,4,5,0,5,BHS
2020-09-01,139,24,7,40,0,179,BRA
2020-09-01,131,4,0,0,0,131,BRN
2020-09-01,1,0,7,32,0,33,CAN
2020-09-01,314,64,134,454,2896,768,CHN
2020-09-01,12,1,1,0,0,12,CIV
2020-09-01,74,0,0,0,0,74,CMR
2020-09-01,49,0,0,0,0,49,COD
2020-09-01,79,0,0,0,0,79,COG
2020-09-01,5,0,1,2,0,7,COL
2020-09-01,3,0,5,3,0,6,CUB
2020-09-01,0,0,1,0,0,0,CYP
2020-09-01,21,17,2,29,1501,50,DEU
2020-09-01,0,0,1,0,0,0,DJI
2020-09-01,20,2,1,21,583,41,DNK
2020-09-01,0,0,2,0,0,0,DOM
2020-09-01,0,0,5,0,0,0,DZA
2020-09-01,12,1,3,2,0,14,ECU
2020-09-01,188,8,1,5,0,193,EGY
2020-09-01,0,0,2,0,0,0,ERI
2020-09-01,3,8,0,5,0,8,ESP
2020-09-01,0,0,0,2,0,2,EST
2020-09-01,0,0,0,51,5,51,FIN
2020-09-01,0,0,3,27,0,27,FRA
2020-09-01,122,0,1,0,0,122,GAB
2020-09-01,147,13,3,13,2421,160,GBR
2020-09-01,1,0,0,0,0,1,GEO
2020-09-01,3,0,8,2,0,5,GHA
2020-09-01,0,0,2,1,0,1,GIN
2020-09-01,0,0,3,9,0,9,GNB
2020-09-01,7,0,0,0,0,7,GNQ
2020-09-01,5,0,0,4,0,9,GRC
2020-09-01,0,0,0,1,0,1,GUY
2020-09-01,16,0,0,3,0,19,HRV
2020-09-01,597,101,86,209,0,806,IDN
2020-09-01,192,1,42,27,0,219,IND
2020-09-01,3,0,1,3,7,6,IRL
2020-09-01,170,4,0,1,0,171,IRN
2020-09-01,2,2,0,8,0,10,IRQ
2020-09-01,0,0,0,2,0,2,ISL
2020-09-01,4,0,2,0,0,4,ISR
2020-09-01,105,9,3,8,0,113,ITA
2020-09-01,0,0,1,1,0,1,JAM
2020-09-01,0,0,0,2,0,2,JEY
2020-09-01,17,13,41,44,0,61,JPN
2020-09-01,0,0,4,0,0,0,KEN
2020-09-01,4,0,2,8,0,12,KHM
2020-09-01,6,0,60,73,12,79,KOR
2020-09-01,32,2,0,40,0,72,KWT
2020-09-01,0,0,5,0,0,0,LBR
2020-09-01,11,0,1,0,0,11,LBY
2020-09-01,0,0,4,4,0,4,LKA
2020-09-01,1,0,0,0,0,1,LTU
2020-09-01,0,0,1,0,0,0,LVA
2020-09-01,0,0,0,1,0,1,MAR
2020-09-01,0,0,1,0,0,0,MDG
2020-09-01,206,3,14,4,0,210,MEX
2020-09-01,4,4,16,8,0,12,MMR
2020-09-01,0,0,1,2,0,2,MOZ
2020-09-01,0,0,1,0,0,0,MRT
2020-09-01,347,76,80,79,0,426,MYS
2020-09-01,14,0,1,0,0,14,NAM
2020-09-01,0,0,1,0,0,0,NCL
2020-09-01,422,3,6,1,0,423,NGA
2020-09-01,0,0,2,1,0,1,NIC
2020-09-01,115,14,1,10,465,125,NLD
2020-09-01,17,0,0,6,1,23,NOR
2020-09-01,8,0,1,5,0,13,NZL
2020-09-01,15,0,22,8,0,23,None
2020-09-01,8,0,1,1,0,9,OMN
2020-09-01,0,0,1,0,0,0,PAK
2020-09-01,0,0,4,4,0,4,PAN
2020-09-01,101,1,4,0,0,101,PER
2020-09-01,7,0,8,54,0,61,PHL
2020-09-01,2,0,3,3,0,5,PNG
2020-09-01,8,3,0,5,3,13,POL
2020-09-01,0,0,2,5,0,5,PRK
2020-09-01,0,0,1,0,0,0,PRT
2020-09-01,172,0,2,3,0,175,QAT
2020-09-01,8,1,0,0,0,8,ROU
2020-09-01,8,1,8,10,0,18,RUS
2020-09-01,721,31,9,2,0,723,SAU
2020-09-01,1,0,2,0,0,1,SDN
2020-09-01,1,0,0,0,0,1,SEN
2020-09-01,0,0,0,39,0,39,SGP
2020-09-01,0,0,1,0,0,0,SLB
2020-09-01,0,0,1,5,0,5,SLE
2020-09-01,0,0,0,1,0,1,SOM
2020-09-01,1,0,1,0,0,1,SUR
2020-09-01,0,0,1,45,65,45,SWE
2020-09-01,4,0,0,0,0,4,TGO
2020-09-01,413,1,27,164,0,577,THA
2020-09-01,3,0,0,0,0,3,TLS
2020-09-01,339,1,1,1,0,340,TTO
2020-09-01,14,14,1,1,0,15,TUN
2020-09-01,5,0,17,51,0,56,TUR
2020-09-01,7,8,3,1,28,8,TWN
2020-09-01,1,0,0,0,0,1,TZA
2020-09-01,13,5,3,16,0,29,UKR
2020-09-01,0,0,1,0,0,0,URY
2020-09-01,2136,45,3,660,7,2796,USA
2020-09-01,11,5,3,7,0,18,VEN
2020-09-01,45,2,21,281,28,326,VNM
2020-09-01,0,0,1,0,0,0,VUT
2020-09-01,3,0,8,1,0,4,YEM
2020-09-01,1,0,4,1,0,2,ZAF
2020-10-01,2,0,1,0,0,2,ABW
2020-10-01,246,4,0,0,0,246,AGO
2020-10-01,522,2,2,12,0,534,ARE
2020-10-01,0,0,1,0,0,0,ASM
2020-10-01,0,0,1,0,0,0,ATG
2020-10-01,74,6,33,60,0,134,AUS
2020-10-01,0,0,1,5,405,5,BEL
2020-10-01,6,0,0,0,0,6,BEN
2020-10-01,0,0,1,0,0,0,BES
2020-10-01,3,2,0,0,0,3,BGD
2020-10-01,1,0,0,0,0,1,BGR
2020-10-01,7,1,1,0,0,7,BHR
2020-10-01,0,0,3,6,0,6,BHS
2020-10-01,139,25,7,42,0,181,BRA
2020-10-01,133,4,0,0,0,133,BRN
2020-10-01,1,0,8,31,0,32,CAN
2020-10-01,0,0,1,0,0,0,CHL
2020-10-01,313,65,135,462,3035,775,CHN
2020-10-01,11,1,1,0,0,11,CIV
2020-10-01,74,0,0,0,0,74,CMR
2020-10-01,49,0,0,0,0,49,COD
2020-10-01,79,0,0,0,0,79,COG
2020-10-01,5,0,1,3,0,8,COL
2020-10-01,3,0,5,2,0,5,CUB
2020-10-01,0,0,1,0,0,0,CYP
2020-10-01,21,17,2,29,1502,50,DEU
2020-10-01,2,0,1,0,0,2,DJI
2020-10-01,19,3,1,22,583,41,DNK
2020-10-01,0,0,2,0,0,0,DOM
2020-10-01,0,0,5,0,0,0,DZA
2020-10-01,13,1,3,2,0,15,ECU
2020-10-01,188,8,1,5,0,193,EGY
2020-10-01,0,0,3,1,0,1,ERI
2020-10-01,3,9,0,6,0,9,ESP
2020-10-01,0,0,0,2,0,2,EST
2020-10-01,0,0,0,51,6,51,FIN
2020-10-01,0,0,3,27,0,27,FRA
2020-10-01,122,0,1,0,0,122,GAB
2020-10-01,147,15,4,16,2436,163,GBR
2020-10-01,1,0,0,0,0,1,GEO
2020-10-01,3,0,9,2,0,5,GHA
2020-10-01,0,0,2,1,0,1,GIN
2020-10-01,0,0,3,8,0,8,GNB
2020-10-01,13,0,0,0,0,13,GNQ
2020-10-01,4,0,0,3,0,7,GRC
2020-10-01,0,0,0,1,0,1,GUY
2020-10-01,16,0,0,3,0,19,HRV
2020-10-01,594,91,78,214,0,808,IDN
2020-10-01,186,2,42,28,0,214,IND
2020-10-01,2,0,1,3,7,5,IRL
2020-10-01,170,4,0,2,0,172,IRN
2020-10-01,1,2,0,7,0,8,IRQ
2020-10-01,0,0,0,2,0,2,ISL
2020-10-01,4,0,2,0,0,4,ISR
2020-10-01,105,9,3,7,0,112,ITA
2020-10-01,0,0,1,1,0,1,JAM
2020-10-01,0,0,0,1,0,1,JEY
2020-10-01,17,12,43,42,0,59,JPN
2020-10-01,0,0,4,0,0,0,KEN
2020-10-01,4,0,2,7,0,11,KHM
2020-10-01,6,0,62,71,12,77,KOR
2020-10-01,34,3,0,54,0,88,KWT
2020-10-01,0,0,5,0,0,0,LBR
2020-10-01,11,0,1,0,0,11,LBY
2020-10-01,0,0,4,4,0,4,LKA
2020-10-01,1,0,0,0,0,1,LTU
2020-10-01,0,0,1,0,0,0,LVA
2020-10-01,0,0,0,2,0,2,MAR
2020-10-01,0,0,1,0,0,0,MDG
2020-10-01,208,3,14,3,0,211,MEX
2020-10-01,4,5,17,8,0,12,MMR
2020-10-01,0,0,1,3,0,3,MOZ
2020-10-01,0,0,1,0,0,0,MRT
2020-10-01,349,77,79,85,0,434,MYS
2020-10-01,13,0,1,0,0,13,NAM
2020-10-01,0,0,1,0,0,0,NCL
2020-10-01,425,3,5,1,0,426,NGA
2020-10-01,0,0,2,1,0,1,NIC
2020-10-01,117,13,1,8,465,125,NLD
2020-10-01,17,0,0,7,1,24,NOR
2020-10-01,8,0,1,4,0,12,NZL
2020-10-01,14,0,20,8,0,22,None
2020-10-01,8,0,1,1,0,9,OMN
2020-10-01,0,0,1,1,0,1,PAK
2020-10-01,0,0,5,4,0,4,PAN
2020-10-01,101,1,3,0,0,101,PER
2020-10-01,7,0,7,54,0,61,PHL
2020-10-01,2,0,1,2,0,4,PNG
2020-10-01,8,3,0,5,3,13,POL
2020-10-01,0,0,2,4,0,4,PRK
2020-10-01,0,0,1,0,0,0,PRT
2020-10-01,173,0,3,3,0,176,QAT
2020-10-01,8,1,0,0,0,8,ROU
2020-10-01,8,2,8,8,0,16,RUS
2020-10-01,725,31,10,2,0,727,SAU
2020-10-01,1,0,2,0,0,1,SDN
2020-10-01,2,0,0,0,0,2,SEN
2020-10-01,0,0,0,40,0,40,SGP
2020-10-01,0,0,1,0,0,0,SLB
2020-10-01,0,0,1,5,0,5,SLE
2020-10-01,0,0,0,1,0,1,SLV
2020-10-01,0,0,0,1,0,1,SOM
2020-10-01,1,0,1,0,0,1,SUR
2020-10-01,0,0,1,45,65,45,SWE
2020-10-01,4,0,0,0,0,4,TGO
2020-10-01,411,1,26,167,0,578,THA
2020-10-01,3,0,0,0,0,3,TLS
2020-10-01,340,1,1,1,0,341,TTO
2020-10-01,14,14,1,1,0,15,TUN
2020-10-01,5,0,17,50,0,55,TUR
2020-10-01,7,10,2,1,28,8,TWN
2020-10-01,1,1,0,0,0,1,TZA
2020-10-01,13,4,3,16,0,29,UKR
2020-10-01,0,0,1,0,0,0,URY
2020-10-01,2138,46,3,658,7,2796,USA
2020-10-01,13,4,3,7,0,20,VEN
2020-10-01,45,2,21,284,87,329,VNM
2020-10-01,0,0,1,0,0,0,VUT
2020-10-01,3,0,9,1,0,4,YEM
2020-10-01,1,0,4,1,0,2,ZAF
2020-11-01,2,0,1,0,0,2,ABW
2020-11-01,248,4,0,0,0,248,AGO
2020-11-01,520,2,2,14,0,534,ARE
2020-11-01,0,0,1,0,0,0,ASM
2020-11-01,0,0,1,0,0,0,ATG
2020-11-01,74,6,35,54,0,128,AUS
2020-11-01,0,0,1,5,405,5,BEL
2020-11-01,6,0,0,1,0,7,BEN
2020-11-01,0,0,1,0,0,0,BES
2020-11-01,3,2,0,0,0,3,BGD
2020-11-01,1,0,0,0,0,1,BGR
2020-11-01,8,1,1,0,0,8,BHR
2020-11-01,0,0,3,5,0,5,BHS
2020-11-01,137,23,8,48,0,185,BRA
2020-11-01,132,4,0,0,0,132,BRN
2020-11-01,1,0,9,27,0,28,CAN
2020-11-01,0,0,2,0,0,0,CHL
2020-11-01,316,65,141,454,3117,770,CHN
2020-11-01,11,1,1,0,0,11,CIV
2020-11-01,75,0,0,0,0,75,CMR
2020-11-01,48,0,0,0,0,48,COD
2020-11-01,76,0,0,0,0,76,COG
2020-11-01,5,0,1,3,0,8,COL
2020-11-01,3,0,5,3,0,6,CUB
2020-11-01,0,0,1,0,0,0,CYP
2020-11-01,21,17,2,29,1503,50,DEU
2020-11-01,2,0,1,0,0,2,DJI
2020-11-01,19,3,1,22,583,41,DNK
2020-11-01,0,0,1,0,0,0,DOM
2020-11-01,0,0,5,0,0,0,DZA
2020-11-01,13,1,3,1,0,14,ECU
2020-11-01,186,7,1,5,0,191,EGY
2020-11-01,0,0,3,2,0,2,ERI
2020-11-01,0,0,0,1,0,1,ESH
2020-11-01,3,9,0,7,0,10,ESP
2020-11-01,0,0,0,2,0,2,EST
2020-11-01,0,0,0,52,6,52,FIN
2020-11-01,0,0,3,22,0,22,FRA
2020-11-01,123,0,1,0,0,123,GAB
2020-11-01,148,14,3,18,2449,166,GBR
2020-11-01,1,0,0,0,0,1,GEO
2020-11-01,3,0,8,2,0,5,GHA
2020-11-01,0,0,3,2,0,2,GIN
2020-11-01,0,0,2,8,0,8,GNB
2020-11-01,13,0,0,0,0,13,GNQ
2020-11-01,4,0,0,2,0,6,GRC
2020-11-01,0,0,1,0,0,0,GUF
2020-11-01,0,0,0,1,0,1,GUY
2020-11-01,16,0,0,3,0,19,HRV
2020-11-01,590,83,72,212,0,802,IDN
2020-11-01,187,2,38,26,0,213,IND
2020-11-01,2,0,1,4,7,6,IRL
2020-11-01,171,4,0,2,0,173,IRN
2020-11-01,1,2,0,6,0,7,IRQ
2020-11-01,0,0,0,3,0,3,ISL
2020-11-01,4,0,2,0,0,4,ISR
2020-11-01,105,8,3,7,0,112,ITA
2020-11-01,0,0,1,1,0,1,JAM
2020-11-01,0,0,0,1,0,1,JEY
2020-11-01,18,13,43,41,0,59,JPN
2020-11-01,0,0,4,0,0,0,KEN
2020-11-01,4,0,2,7,0,11,KHM
2020-11-01,6,0,65,67,12,73,KOR
2020-11-01,34,3,0,56,0,90,KWT
2020-11-01,0,0,9,1,0,1,LBR
2020-11-01,10,0,1,0,0,10,LBY
2020-11-01,0,0,4,4,0,4,LKA
2020-11-01,1,0,0,0,0,1,LTU
2020-11-01,0,0,1,1,0,1,LVA
2020-11-01,0,0,0,1,0,1,MAR
2020-11-01,0,0,1,0,0,0,MDG
2020-11-01,208,3,13,4,0,212,MEX
2020-11-01,4,6,16,8,0,12,MMR
2020-11-01,0,0,1,3,0,3,MOZ
2020-11-01,0,0,1,0,0,0,MRT
2020-11-01,346,76,69,90,0,436,MYS
2020-11-01,11,0,1,0,0,11,NAM
2020-11-01,0,0,1,0,0,0,NCL
2020-11-01,426,3,3,1,0,427,NGA
2020-11-01,0,0,2,1,0,1,NIC
2020-11-01,117,13,1,7,464,124,NLD
2020-11-01,16,0,0,7,1,23,NOR
2020-11-01,8,0,1,4,0,12,NZL
2020-11-01,16,0,16,7,0,23,None
2020-11-01,8,0,2,2,0,10,OMN
2020-11-01,0,0,1,1,0,1,PAK
2020-11-01,0,0,5,6,0,6,PAN
2020-11-01,97,1,4,0,0,97,PER
2020-11-01,7,0,9,54,0,61,PHL
2020-11-01,2,0,1,2,0,4,PNG
2020-11-01,8,3,0,6,3,14,POL
2020-11-01,0,0,2,4,0,4,PRK
2020-11-01,0,0,1,0,0,0,PRT
2020-11-01,178,0,3,2,0,180,QAT
2020-11-01,8,1,0,0,0,8,ROU
2020-11-01,8,2,5,6,0,14,RUS
2020-11-01,728,29,9,2,0,730,SAU
2020-11-01,1,0,2,0,0,1,SDN
2020-11-01,2,0,0,0,0,2,SEN
2020-11-01,0,0,0,35,0,35,SGP
2020-11-01,0,0,1,0,0,0,SLB
2020-11-01,0,0,1,5,0,5,SLE
2020-11-01,0,0,0,1,0,1,SLV
2020-11-01,0,0,0,1,0,1,SOM
2020-11-01,1,0,0,0,0,1,SUR
2020-11-01,0,0,1,44,65,44,SWE
2020-11-01,4,0,0,0,0,4,TGO
2020-11-01,411,1,25,165,0,576,THA
2020-11-01,3,0,0,0,0,3,TLS
2020-11-01,343,1,1,1,0,344,TTO
2020-11-01,14,14,1,1,0,15,TUN
2020-11-01,5,0,16,50,0,55,TUR
2020-11-01,7,10,2,0,28,7,TWN
2020-11-01,1,1,0,0,0,1,TZA
2020-11-01,13,4,3,15,0,28,UKR
2020-11-01,0,0,1,0,0,0,URY
2020-11-01,2151,46,4,651,7,2802,USA
2020-11-01,13,4,3,6,0,19,VEN
2020-11-01,44,2,18,284,94,328,VNM
2020-11-01,0,0,1,0,0,0,VUT
2020-11-01,4,0,8,3,0,7,YEM
2020-11-01,1,0,4,1,0,2,ZAF
2020-12-01,2,0,1,0,0,2,ABW
2020-12-01,247,4,0,0,0,247,AGO
2020-12-01,517,1,1,10,0,527,ARE
2020-12-01,0,0,1,0,0,0,ASM
2020-12-01,0,0,1,0,0,0,ATG
2020-12-01,76,6,36,56,0,132,AUS
2020-12-01,0,0,1,5,405,5,BEL
2020-12-01,6,0,0,1,0,7,BEN
2020-12-01,0,0,1,0,0,0,BES
2020-12-01,3,3,0,0,0,3,BGD
2020-12-01,1,0,0,0,0,1,BGR
2020-12-01,8,0,1,0,0,8,BHR
2020-12-01,0,0,3,5,0,5,BHS
2020-12-01,136,20,11,48,0,184,BRA
2020-12-01,132,4,0,0,0,132,BRN
2020-12-01,0,0,9,23,0,23,CAN
2020-12-01,0,0,2,0,0,0,CHL
2020-12-01,316,66,149,466,3216,782,CHN
2020-12-01,11,1,1,0,0,11,CIV
2020-12-01,75,0,0,0,0,75,CMR
2020-12-01,50,0,0,0,0,50,COD
2020-12-01,76,0,0,0,0,76,COG
2020-12-01,5,0,3,4,0,9,COL
2020-12-01,3,0,5,3,0,6,CUB
2020-12-01,0,0,1,0,0,0,CYP
2020-12-01,21,17,2,29,1502,50,DEU
2020-12-01,2,0,1,0,0,2,DJI
2020-12-01,18,3,1,22,583,40,DNK
2020-12-01,0,0,1,0,0,0,DOM
2020-12-01,0,0,5,0,0,0,DZA
2020-12-01,11,1,2,1,0,12,ECU
2020-12-01,185,7,0,5,0,190,EGY
2020-12-01,0,0,3,1,0,1,ERI
2020-12-01,0,0,0,1,0,1,ESH
2020-12-01,3,9,0,6,0,9,ESP
2020-12-01,0,0,0,2,0,2,EST
2020-12-01,0,0,0,52,6,52,FIN
2020-12-01,0,0,3,20,0,20,FRA
2020-12-01,125,0,1,0,0,125,GAB
2020-12-01,151,15,3,19,2519,170,GBR
2020-12-01,1,0,0,0,0,1,GEO
2020-12-01,3,0,7,2,0,5,GHA
2020-12-01,0,0,4,2,0,2,GIN
2020-12-01,0,0,3,9,0,9,GNB
2020-12-01,13,0,0,0,0,13,GNQ
2020-12-01,5,0,0,3,0,8,GRC
2020-12-01,0,0,1,0,0,0,GUF
2020-12-01,0,0,0,1,0,1,GUY
2020-12-01,15,0,0,3,0,18,HRV
2020-12-01,467,68,73,210,0,677,IDN
2020-12-01,193,2,36,29,0,222,IND
2020-12-01,3,0,1,4,7,7,IRL
2020-12-01,168,4,0,2,0,170,IRN
2020-12-01,1,1,0,7,0,8,IRQ
2020-12-01,0,0,0,3,0,3,ISL
2020-12-01,4,0,1,0,0,4,ISR
2020-12-01,104,8,3,5,0,109,ITA
2020-12-01,0,0,1,1,0,1,JAM
2020-12-01,0,0,0,1,0,1,JEY
2020-12-01,18,14,43,45,0,63,JPN
2020-12-01,0,0,4,0,0,0,KEN
2020-12-01,3,0,1,6,0,9,KHM
2020-12-01,6,0,66,67,12,73,KOR
2020-12-01,31,4,0,52,0,83,KWT
2020-12-01,0,0,1,0,0,0,LBN
2020-12-01,0,0,10,1,0,1,LBR
2020-12-01,9,0,1,0,0,9,LBY
2020-12-01,0,0,5,3,0,3,LKA
2020-12-01,1,0,0,0,0,1,LTU
2020-12-01,0,0,1,1,0,1,LVA
2020-12-01,0,0,1,0,0,0,MDG
2020-12-01,208,3,14,6,0,214,MEX
2020-12-01,4,3,16,11,0,15,MMR
2020-12-01,1,0,0,3,0,4,MOZ
2020-12-01,0,0,1,0,0,0,MRT
2020-12-01,342,76,73,90,0,432,MYS
2020-12-01,11,0,0,0,0,11,NAM
2020-12-01,428,3,3,1,0,429,NGA
2020-12-01,0,0,2,1,0,1,NIC
2020-12-01,115,13,1,8,464,123,NLD
2020-12-01,14,0,0,6,1,20,NOR
2020-12-01,8,0,1,5,0,13,NZL
2020-12-01,17,0,16,6,0,23,None
2020-12-01,8,0,2,2,0,10,OMN
2020-12-01,0,0,1,1,0,1,PAK
2020-12-01,0,0,5,7,0,7,PAN
2020-12-01,94,1,5,0,0,94,PER
2020-12-01,7,0,15,49,0,56,PHL
2020-12-01,2,0,1,2,0,4,PNG
2020-12-01,8,3,0,6,3,14,POL
2020-12-01,0,0,4,5,0,5,PRK
2020-12-01,0,0,1,1,0,1,PRT
2020-12-01,179,0,3,2,0,181,QAT
2020-12-01,8,1,0,0,0,8,ROU
2020-12-01,6,1,5,5,0,11,RUS
2020-12-01,734,28,8,2,0,736,SAU
2020-12-01,1,0,2,0,0,1,SDN
2020-12-01,2,0,0,0,0,2,SEN
2020-12-01,0,0,0,29,0,29,SGP
2020-12-01,0,0,1,0,0,0,SLB
2020-12-01,0,0,1,4,0,4,SLE
2020-12-01,0,0,0,1,0,1,SLV
2020-12-01,0,0,1,1,0,1,SOM
2020-12-01,1,0,0,0,0,1,SUR
2020-12-01,0,0,1,41,65,41,SWE
2020-12-01,4,0,0,0,0,4,TGO
2020-12-01,411,1,26,160,0,571,THA
2020-12-01,3,0,0,0,0,3,TLS
2020-12-01,341,1,1,1,0,342,TTO
2020-12-01,13,14,1,1,0,14,TUN
2020-12-01,5,0,14,47,0,52,TUR
2020-12-01,7,10,2,0,28,7,TWN
2020-12-01,1,1,0,0,0,1,TZA
2020-12-01,13,4,3,15,0,28,UKR
2020-12-01,0,0,1,0,0,0,URY
2020-12-01,2160,44,2,653,7,2813,USA
2020-12-01,12,3,3,6,0,18,VEN
2020-12-01,45,2,19,285,96,330,VNM
2020-12-01,0,0,1,0,0,0,VUT
2020-12-01,4,0,9,4,0,8,YEM
2020-12-01,1,0,4,0,0,1,ZAF
2021-01-01,2,0,1,0,0,2,ABW
2021-01-01,246,2,1,0,0,246,AGO
2021-01-01,518,1,1,9,0,527,ARE
2021-01-01,0,0,1,0,0,0,ASM
2021-01-01,0,0,1,0,0,0,ATG
2021-01-01,75,5,37,53,0,128,AUS
2021-01-01,0,0,1,5,405,5,BEL
2021-01-01,6,0,0,1,0,7,BEN
2021-01-01,0,0,1,0,0,0,BES
2021-01-01,3,4,0,0,0,3,BGD
2021-01-01,1,0,0,0,0,1,BGR
2021-01-01,8,0,1,0,0,8,BHR
2021-01-01,0,0,3,4,0,4,BHS
2021-01-01,139,19,11,49,0,188,BRA
2021-01-01,133,4,0,0,0,133,BRN
2021-01-01,0,0,8,22,0,22,CAN
2021-01-01,0,0,1,0,0,0,CHL
2021-01-01,313,64,151,465,3319,778,CHN
2021-01-01,11,1,1,0,0,11,CIV
2021-01-01,75,0,0,0,0,75,CMR
2021-01-01,51,0,0,0,0,51,COD
2021-01-01,75,0,0,0,0,75,COG
2021-01-01,5,0,3,4,0,9,COL
2021-01-01,3,0,5,1,0,4,CUB
2021-01-01,0,0,1,0,0,0,CYP
2021-01-01,20,18,2,29,1501,49,DEU
2021-01-01,1,0,1,0,0,1,DJI
2021-01-01,19,3,1,22,583,41,DNK
2021-01-01,0,0,2,0,0,0,DOM
2021-01-01,0,0,5,1,0,1,DZA
2021-01-01,9,0,2,0,0,9,ECU
2021-01-01,184,5,0,6,0,190,EGY
2021-01-01,0,0,3,1,0,1,ERI
2021-01-01,0,0,0,1,0,1,ESH
2021-01-01,3,8,0,6,0,9,ESP
2021-01-01,0,0,0,1,0,1,EST
2021-01-01,0,0,0,49,5,49,FIN
2021-01-01,0,0,3,18,0,18,FRA
2021-01-01,124,0,1,0,0,124,GAB
2021-01-01,153,15,3,21,2524,174,GBR
2021-01-01,1,0,0,1,0,2,GEO
2021-01-01,3,0,5,2,0,5,GHA
2021-01-01,0,0,5,2,0,2,GIN
2021-01-01,0,0,3,10,0,10,GNB
2021-01-01,13,0,0,0,0,13,GNQ
2021-01-01,5,0,0,3,0,8,GRC
2021-01-01,0,0,1,0,0,0,GUF
2021-01-01,0,0,0,1,0,1,GUY
2021-01-01,15,0,0,3,0,18,HRV
2021-01-01,467,76,74,215,0,682,IDN
2021-01-01,191,1,34,24,0,215,IND
2021-01-01,3,0,1,3,7,6,IRL
2021-01-01,167,4,1,2,0,169,IRN
2021-01-01,1,1,0,8,0,9,IRQ
2021-01-01,0,0,0,3,0,3,ISL
2021-01-01,4,0,1,0,0,4,ISR
2021-01-01,103,7,3,5,0,108,ITA
2021-01-01,0,0,1,1,0,1,JAM
2021-01-01,0,0,0,1,0,1,JEY
2021-01-01,18,14,45,40,0,58,JPN
2021-01-01,0,0,4,0,0,0,KEN
2021-01-01,3,0,1,8,0,11,KHM
2021-01-01,6,0,69,73,12,79,KOR
2021-01-01,32,4,0,52,0,84,KWT
2021-01-01,0,0,1,0,0,0,LBN
2021-01-01,0,0,10,1,0,1,LBR
2021-01-01,9,0,1,0,0,9,LBY
2021-01-01,0,0,5,3,0,3,LKA
2021-01-01,1,0,0,0,0,1,LTU
2021-01-01,0,0,1,1,0,1,LVA
2021-01-01,0,0,2,0,0,0,MDG
2021-01-01,213,3,14,6,0,219,MEX
2021-01-01,1,0,0,0,0,1,MLT
2021-01-01,4,2,17,11,0,15,MMR
2021-01-01,1,0,0,3,0,4,MOZ
2021-01-01,0,0,1,0,0,0,MRT
2021-01-01,339,83,70,91,0,430,MYS
2021-01-01,10,0,0,0,0,10,NAM
2021-01-01,434,3,3,1,0,435,NGA
2021-01-01,0,0,2,1,0,1,NIC
2021-01-01,112,12,1,8,464,120,NLD
2021-01-01,13,0,0,6,1,19,NOR
2021-01-01,8,0,1,6,0,14,NZL
2021-01-01,18,0,16,7,0,25,None
2021-01-01,8,0,3,2,0,10,OMN
2021-01-01,0,0,1,1,0,1,PAK
2021-01-01,0,0,5,7,0,7,PAN
2021-01-01,92,1,4,1,0,93,PER
2021-01-01,8,0,15,44,0,52,PHL
2021-01-01,2,0,1,3,0,5,PNG
2021-01-01,8,3,0,6,3,14,POL
2021-01-01,0,0,4,5,0,5,PRK
2021-01-01,0,0,1,1,0,1,PRT
2021-01-01,177,0,4,2,0,179,QAT
2021-01-01,8,0,0,0,0,8,ROU
2021-01-01,6,1,3,5,0,11,RUS
2021-01-01,729,29,8,1,0,730,SAU
2021-01-01,1,0,2,0,0,1,SDN
2021-01-01,2,0,0,0,0,2,SEN
2021-01-01,0,0,0,32,0,32,SGP
2021-01-01,0,0,1,0,0,0,SLB
2021-01-01,0,0,1,4,0,4,SLE
2021-01-01,0,0,0,1,0,1,SLV
2021-01-01,0,0,1,1,0,1,SOM
2021-01-01,1,0,0,0,0,1,SUR
2021-01-01,0,0,1,43,65,43,SWE
2021-01-01,4,0,0,0,0,4,TGO
2021-01-01,410,1,27,136,0,546,THA
2021-01-01,3,0,0,0,0,3,TLS
2021-01-01,336,1,0,1,0,337,TTO
2021-01-01,14,14,1,1,0,15,TUN
2021-01-01,5,1,12,45,0,50,TUR
2021-01-01,7,10,2,0,29,7,TWN
2021-01-01,1,1,0,0,0,1,TZA
2021-01-01,13,4,3,13,0,26,UKR
2021-01-01,0,0,1,0,0,0,URY
2021-01-01,2166,48,2,675,7,2841,USA
2021-01-01,12,4,3,7,0,19,VEN
2021-01-01,44,2,20,293,96,337,VNM
2021-01-01,0,0,1,0,0,0,VUT
2021-01-01,2,0,10,5,0,7,YEM
2021-01-01,1,0,3,0,0,1,ZAF
2021-02-01,2,0,1,0,0,2,ABW
2021-02-01,249,1,1,0,0,249,AGO
2021-02-01,516,1,1,9,0,525,ARE
2021-02-01,0,0,1,0,0,0,ASM
2021-02-01,0,0,1,0,0,0,ATG
2021-02-01,74,5,40,58,0,132,AUS
2021-02-01,0,0,1,5,405,5,BEL
2021-02-01,6,0,0,1,0,7,BEN
2021-02-01,0,0,1,0,0,0,BES
2021-02-01,3,4,0,0,0,3,BGD
2021-02-01,1,0,0,0,0,1,BGR
2021-02-01,7,0,1,0,0,7,BHR
2021-02-01,0,0,3,4,0,4,BHS
2021-02-01,138,19,12,48,0,186,BRA
2021-02-01,132,4,0,0,0,132,BRN
2021-02-01,0,0,8,22,0,22,CAN
2021-02-01,0,0,1,0,0,0,CHL
2021-02-01,316,69,150,478,3479,794,CHN
2021-02-01,11,1,1,0,0,11,CIV
2021-02-01,75,0,0,0,0,75,CMR
2021-02-01,51,0,0,0,0,51,COD
2021-02-01,75,0,0,0,0,75,COG
2021-02-01,5,1,3,3,0,8,COL
2021-02-01,3,0,5,1,0,4,CUB
2021-02-01,0,0,1,0,0,0,CYP
2021-02-01,20,19,2,28,1501,48,DEU
2021-02-01,1,0,1,0,0,1,DJI
2021-02-01,20,2,1,21,583,41,DNK
2021-02-01,0,0,2,0,0,0,DOM
2021-02-01,0,0,4,1,0,1,DZA
2021-02-01,9,0,3,0,0,9,ECU
2021-02-01,186,3,0,6,0,192,EGY
2021-02-01,0,0,3,1,0,1,ERI
2021-02-01,3,8,0,6,0,9,ESP
2021-02-01,0,0,0,1,0,1,EST
2021-02-01,0,0,0,49,5,49,FIN
2021-02-01,0,0,0,1,0,1,FJI
2021-02-01,0,0,3,22,0,22,FRA
2021-02-01,124,0,1,0,0,124,GAB
2021-02-01,158,15,4,22,2547,180,GBR
2021-02-01,1,0,0,1,0,2,GEO
2021-02-01,0,0,0,3,0,3,GGY
2021-02-01,3,0,6,2,0,5,GHA
2021-02-01,0,0,5,2,0,2,GIN
2021-02-01,0,0,2,12,0,12,GNB
2021-02-01,13,0,0,0,0,13,GNQ
2021-02-01,4,0,0,2,0,6,GRC
2021-02-01,0,0,0,1,0,1,GUY
2021-02-01,15,0,0,3,0,18,HRV
2021-02-01,469,73,77,209,0,678,IDN
2021-02-01,194,2,33,28,0,222,IND
2021-02-01,3,0,1,3,7,6,IRL
2021-02-01,168,5,1,2,0,170,IRN
2021-02-01,1,1,0,9,0,10,IRQ
2021-02-01,0,0,0,3,0,3,ISL
2021-02-01,4,0,1,0,0,4,ISR
2021-02-01,104,7,3,5,0,109,ITA
2021-02-01,0,0,1,1,0,1,JAM
2021-02-01,0,0,0,2,0,2,JEY
2021-02-01,19,15,48,40,0,59,JPN
2021-02-01,0,0,4,0,0,0,KEN
2021-02-01,3,0,1,8,0,11,KHM
2021-02-01,6,0,69,79,12,85,KOR
2021-02-01,31,4,0,53,0,84,KWT
2021-02-01,0,0,1,0,0,0,LBN
2021-02-01,0,0,9,1,0,1,LBR
2021-02-01,10,0,1,0,0,10,LBY
2021-02-01,0,0,5,4,0,4,LKA
2021-02-01,1,0,0,0,0,1,LTU
2021-02-01,0,0,1,0,0,0,LVA
2021-02-01,0,0,2,0,0,0,MDG
2021-02-01,210,4,14,5,0,215,MEX
2021-02-01,1,0,0,0,0,1,MLT
2021-02-01,4,3,17,14,0,18,MMR
2021-02-01,1,1,1,3,0,4,MOZ
2021-02-01,0,0,1,0,0,0,MRT
2021-02-01,338,85,65,95,0,433,MYS
2021-02-01,11,0,0,0,0,11,NAM
2021-02-01,434,3,4,1,0,435,NGA
2021-02-01,0,0,2,1,0,1,NIC
2021-02-01,111,11,1,9,465,120,NLD
2021-02-01,13,0,0,7,1,20,NOR
2021-02-01,8,0,1,6,0,14,NZL
2021-02-01,18,0,14,7,0,25,None
2021-02-01,8,0,3,2,0,10,OMN
2021-02-01,0,0,1,1,0,1,PAK
2021-02-01,0,0,5,5,0,5,PAN
2021-02-01,96,1,4,1,0,97,PER
2021-02-01,8,0,14,51,0,59,PHL
2021-02-01,2,0,1,4,0,6,PNG
2021-02-01,8,3,0,8,3,16,POL
2021-02-01,0,0,5,4,0,4,PRK
2021-02-01,0,0,1,1,0,1,PRT
2021-02-01,176,0,4,2,0,178,QAT
2021-02-01,8,0,0,0,0,8,ROU
2021-02-01,6,1,3,5,0,11,RUS
2021-02-01,725,28,9,1,0,726,SAU
2021-02-01,1,0,2,0,0,1,SDN
2021-02-01,4,0,0,0,0,4,SEN
2021-02-01,0,0,0,42,0,42,SGP
2021-02-01,0,0,1,0,0,0,SLB
2021-02-01,0,0,1,4,0,4,SLE
2021-02-01,0,0,0,1,0,1,SLV
2021-02-01,0,0,1,1,0,1,SOM
2021-02-01,1,0,0,0,0,1,SUR
2021-02-01,0,0,1,46,65,46,SWE
2021-02-01,2,0,0,0,0,2,TGO
2021-02-01,410,1,28,120,0,530,THA
2021-02-01,3,0,0,0,0,3,TLS
2021-02-01,325,1,0,1,0,326,TTO
2021-02-01,14,14,1,1,0,15,TUN
2021-02-01,5,1,13,45,0,50,TUR
2021-02-01,7,10,1,0,29,7,TWN
2021-02-01,1,1,0,0,0,1,TZA
2021-02-01,13,4,3,13,0,26,UKR
2021-02-01,0,0,1,0,0,0,URY
2021-02-01,2167,48,3,680,7,2847,USA
2021-02-01,10,4,3,7,0,17,VEN
2021-02-01,44,2,23,296,101,340,VNM
2021-02-01,0,0,1,0,0,0,VUT
2021-02-01,3,0,11,5,0,8,YEM
2021-02-01,1,0,4,0,0,1,ZAF
2021-03-01,2,0,1,0,0,2,ABW
2021-03-01,248,2,1,0,0,248,AGO
2021-03-01,515,1,1,9,0,524,ARE
2021-03-01,0,0,1,0,0,0,ASM
2021-03-01,0,0,1,0,0,0,ATG
2021-03-01,75,5,36,58,0,133,AUS
2021-03-01,0,0,1,5,405,5,BEL
2021-03-01,6,0,0,1,0,7,BEN
2021-03-01,0,0,1,0,0,0,BES
2021-03-01,3,5,0,0,0,3,BGD
2021-03-01,1,0,0,0,0,1,BGR
2021-03-01,7,0,1,0,0,7,BHR
2021-03-01,0,0,3,4,0,4,BHS
2021-03-01,137,16,12,48,0,185,BRA
2021-03-01,132,4,0,0,0,132,BRN
2021-03-01,0,0,7,27,0,27,CAN
2021-03-01,0,0,2,0,0,0,CHL
2021-03-01,317,64,149,487,3601,804,CHN
2021-03-01,11,1,1,0,0,11,CIV
2021-03-01,75,0,0,0,0,75,CMR
2021-03-01,52,0,0,0,0,52,COD
2021-03-01,76,0,0,0,0,76,COG
2021-03-01,5,1,3,3,0,8,COL
2021-03-01,3,0,5,1,0,4,CUB
2021-03-01,0,0,1,0,0,0,CYP
2021-03-01,21,18,2,29,1501,50,DEU
2021-03-01,0,0,1,0,0,0,DJI
2021-03-01,18,2,1,19,584,37,DNK
2021-03-01,0,0,2,0,0,0,DOM
2021-03-01,0,0,4,1,0,1,DZA
2021-03-01,12,1,3,0,0,12,ECU
2021-03-01,186,3,0,6,0,192,EGY
2021-03-01,0,0,3,2,0,2,ERI
2021-03-01,3,8,0,7,0,10,ESP
2021-03-01,0,0,0,1,0,1,EST
2021-03-01,0,0,0,50,6,50,FIN
2021-03-01,0,0,0,1,0,1,FJI
2021-03-01,0,0,3,24,0,24,FRA
2021-03-01,123,0,1,0,0,123,GAB
2021-03-01,159,17,4,17,2550,176,GBR
2021-03-01,1,0,0,1,0,2,GEO
2021-03-01,0,0,0,3,0,3,GGY
2021-03-01,3,0,5,1,0,4,GHA
2021-03-01,0,0,4,2,0,2,GIN
2021-03-01,0,0,2,12,0,12,GNB
2021-03-01,14,0,0,0,0,14,GNQ
2021-03-01,4,0,0,2,0,6,GRC
2021-03-01,0,0,0,1,0,1,GUY
2021-03-01,15,0,0,3,0,18,HRV
2021-03-01,594,86,75,216,0,810,IDN
2021-03-01,192,2,34,33,0,225,IND
2021-03-01,3,0,1,3,7,6,IRL
2021-03-01,166,4,1,3,0,169,IRN
2021-03-01,1,1,0,10,0,11,IRQ
2021-03-01,0,0,0,3,0,3,ISL
2021-03-01,4,0,1,0,0,4,ISR
2021-03-01,104,8,4,6,0,110,ITA
2021-03-01,0,0,1,1,0,1,JAM
2021-03-01,0,0,0,2,0,2,JEY
2021-03-01,19,14,47,38,0,57,JPN
2021-03-01,0,0,4,0,0,0,KEN
2021-03-01,3,0,1,7,0,10,KHM
2021-03-01,6,0,70,76,12,82,KOR
2021-03-01,31,2,0,44,0,75,KWT
2021-03-01,0,0,8,1,0,1,LBR
2021-03-01,10,0,1,0,0,10,LBY
2021-03-01,0,0,5,4,0,4,LKA
2021-03-01,1,0,0,0,0,1,LTU
2021-03-01,0,0,1,0,0,0,LVA
2021-03-01,0,0,2,0,0,0,MDG
2021-03-01,211,4,12,5,0,216,MEX
2021-03-01,1,0,0,0,0,1,MLT
2021-03-01,5,6,17,14,0,19,MMR
2021-03-01,1,1,1,3,0,4,MOZ
2021-03-01,0,0,1,0,0,0,MRT
2021-03-01,338,80,58,90,0,428,MYS
2021-03-01,10,0,0,0,0,10,NAM
2021-03-01,433,3,4,1,0,434,NGA
2021-03-01,0,0,2,1,0,1,NIC
2021-03-01,116,12,1,9,465,125,NLD
2021-03-01,14,0,0,9,1,23,NOR
2021-03-01,8,0,1,6,0,14,NZL
2021-03-01,18,0,14,6,0,24,None
2021-03-01,9,0,2,2,0,11,OMN
2021-03-01,0,0,1,1,0,1,PAK
2021-03-01,1,0,5,6,0,7,PAN
2021-03-01,98,2,3,1,0,99,PER
2021-03-01,8,0,16,55,0,63,PHL
2021-03-01,2,0,1,4,0,6,PNG
2021-03-01,8,3,0,8,3,16,POL
2021-03-01,0,0,4,4,0,4,PRK
2021-03-01,0,0,1,0,0,0,PRT
2021-03-01,175,0,4,2,0,177,QAT
2021-03-01,8,0,0,0,0,8,ROU
2021-03-01,7,1,3,6,0,13,RUS
2021-03-01,723,28,10,1,0,724,SAU
2021-03-01,1,0,2,0,0,1,SDN
2021-03-01,4,0,0,0,0,4,SEN
2021-03-01,1,0,0,41,0,42,SGP
2021-03-01,0,0,1,0,0,0,SLB
2021-03-01,0,0,0,2,0,2,SLE
2021-03-01,0,0,0,1,0,1,SLV
2021-03-01,0,0,1,1,0,1,SOM
2021-03-01,2,0,0,1,0,3,SUR
2021-03-01,0,0,1,47,65,47,SWE
2021-03-01,2,0,0,0,0,2,TGO
2021-03-01,409,1,29,110,0,519,THA
2021-03-01,3,0,0,0,0,3,TLS
2021-03-01,325,1,0,1,0,326,TTO
2021-03-01,14,14,1,1,0,15,TUN
2021-03-01,5,1,14,45,0,50,TUR
2021-03-01,7,8,3,0,29,7,TWN
2021-03-01,1,1,0,0,0,1,TZA
2021-03-01,13,4,2,12,0,25,UKR
2021-03-01,0,0,1,0,0,0,URY
2021-03-01,2162,45,4,698,7,2860,USA
2021-03-01,11,4,3,8,0,19,VEN
2021-03-01,43,2,24,287,108,330,VNM
2021-03-01,0,0,1,0,0,0,VUT
2021-03-01,3,0,11,5,0,8,YEM
2021-03-01,1,0,4,0,0,1,ZAF
2021-04-01,2,0,1,0,0,2,ABW
2021-04-01,249,2,1,0,0,249,AGO
2021-04-01,519,1,1,11,0,530,ARE
2021-04-01,0,0,1,0,0,0,ASM
2021-04-01,0,0,1,0,0,0,ATG
2021-04-01,77,5,33,58,0,135,AUS
2021-04-01,0,0,1,5,405,5,BEL
2021-04-01,6,0,0,0,0,6,BEN
2021-04-01,0,0,1,0,0,0,BES
2021-04-01,3,5,0,0,0,3,BGD
2021-04-01,1,0,0,0,0,1,BGR
2021-04-01,7,1,1,0,0,7,BHR
2021-04-01,0,0,3,5,0,5,BHS
2021-04-01,0,0,1,0,0,0,BLZ
2021-04-01,135,16,12,49,0,184,BRA
2021-04-01,132,4,0,0,0,132,BRN
2021-04-01,0,0,7,30,0,30,CAN
2021-04-01,0,0,2,0,0,0,CHL
2021-04-01,316,61,142,483,3751,799,CHN
2021-04-01,11,1,1,0,0,11,CIV
2021-04-01,75,0,0,0,0,75,CMR
2021-04-01,50,0,0,0,0,50,COD
2021-04-01,78,0,0,0,0,78,COG
2021-04-01,5,1,3,3,0,8,COL
2021-04-01,3,0,5,1,0,4,CUB
2021-04-01,0,0,1,0,0,0,CYP
2021-04-01,21,19,2,29,1501,50,DEU
2021-04-01,0,0,1,0,0,0,DJI
2021-04-01,18,2,1,21,584,39,DNK
2021-04-01,0,0,1,0,0,0,DOM
2021-04-01,0,0,4,1,0,1,DZA
2021-04-01,12,1,3,0,0,12,ECU
2021-04-01,184,3,0,6,0,190,EGY
2021-04-01,0,0,2,2,0,2,ERI
2021-04-01,2,8,0,8,0,10,ESP
2021-04-01,0,0,0,1,0,1,EST
2021-04-01,0,0,0,53,7,53,FIN
2021-04-01,0,0,3,26,0,26,FRA
2021-04-01,120,0,1,0,0,120,GAB
2021-04-01,152,18,3,20,2566,172,GBR
2021-04-01,1,0,0,1,0,2,GEO
2021-04-01,0,0,0,3,0,3,GGY
2021-04-01,3,0,5,1,0,4,GHA
2021-04-01,0,0,4,2,0,2,GIN
2021-04-01,0,0,1,10,0,10,GNB
2021-04-01,15,0,0,0,0,15,GNQ
2021-04-01,5,0,0,3,0,8,GRC
2021-04-01,0,0,0,1,0,1,GUY
2021-04-01,15,0,0,3,0,18,HRV
2021-04-01,594,77,75,216,0,810,IDN
2021-04-01,193,2,36,37,0,230,IND
2021-04-01,3,0,1,4,7,7,IRL
2021-04-01,166,4,1,4,0,170,IRN
2021-04-01,1,1,0,9,0,10,IRQ
2021-04-01,0,0,0,3,0,3,ISL
2021-04-01,4,0,1,0,0,4,ISR
2021-04-01,103,9,4,6,0,109,ITA
2021-04-01,0,0,1,1,0,1,JAM
2021-04-01,0,0,0,4,0,4,JEY
2021-04-01,20,14,46,36,0,56,JPN
2021-04-01,0,0,4,0,0,0,KEN
2021-04-01,4,0,1,7,0,11,KHM
2021-04-01,7,0,71,75,12,82,KOR
2021-04-01,34,1,0,45,0,79,KWT
2021-04-01,0,0,7,1,0,1,LBR
2021-04-01,10,0,2,0,0,10,LBY
2021-04-01,0,0,5,4,0,4,LKA
2021-04-01,1,0,0,0,0,1,LTU
2021-04-01,0,0,1,0,0,0,LVA
2021-04-01,0,0,2,0,0,0,MDG
2021-04-01,217,4,11,6,0,223,MEX
2021-04-01,1,0,0,0,0,1,MLT
2021-04-01,4,4,17,12,0,16,MMR
2021-04-01,1,1,1,3,0,4,MOZ
2021-04-01,0,0,1,0,0,0,MRT
2021-04-01,334,75,59,89,0,423,MYS
2021-04-01,10,0,0,0,0,10,NAM
2021-04-01,438,3,7,1,0,439,NGA
2021-04-01,0,0,2,1,0,1,NIC
2021-04-01,115,12,1,12,465,127,NLD
2021-04-01,16,0,0,9,1,25,NOR
2021-04-01,8,0,1,5,0,13,NZL
2021-04-01,18,0,14,6,0,24,None
2021-04-01,9,0,4,1,0,10,OMN
2021-04-01,0,0,1,1,0,1,PAK
2021-04-01,1,0,5,6,0,7,PAN
2021-04-01,99,2,3,1,0,100,PER
2021-04-01,7,0,15,59,0,66,PHL
2021-04-01,2,0,0,3,0,5,PNG
2021-04-01,8,3,0,7,3,15,POL
2021-04-01,0,0,4,4,0,4,PRK
2021-04-01,0,0,1,0,0,0,PRT
2021-04-01,175,0,4,2,0,177,QAT
2021-04-01,9,0,0,0,0,9,ROU
2021-04-01,8,1,4,6,0,14,RUS
2021-04-01,727,26,10,1,0,728,SAU
2021-04-01,1,0,2,0,0,1,SDN
2021-04-01,4,0,0,0,0,4,SEN
2021-04-01,1,0,0,34,0,35,SGP
2021-04-01,0,0,1,0,0,0,SLB
2021-04-01,0,0,0,2,0,2,SLE
2021-04-01,0,0,0,1,0,1,SOM
2021-04-01,2,0,0,2,0,4,SUR
2021-04-01,0,0,1,46,65,46,SWE
2021-04-01,1,0,0,0,0,1,TGO
2021-04-01,409,1,24,102,0,511,THA
2021-04-01,3,0,0,0,0,3,TLS
2021-04-01,325,1,0,1,0,326,TTO
2021-04-01,13,14,1,1,0,14,TUN
2021-04-01,5,1,14,45,0,50,TUR
2021-04-01,8,8,4,0,30,8,TWN
2021-04-01,1,1,0,0,0,1,TZA
2021-04-01,13,4,2,11,0,24,UKR
2021-04-01,0,0,1,0,0,0,URY
2021-04-01,2159,42,3,704,7,2863,USA
2021-04-01,11,5,3,7,0,18,VEN
2021-04-01,44,2,22,286,146,330,VNM
2021-04-01,0,0,1,0,0,0,VUT
2021-04-01,3,0,11,4,0,7,YEM
2021-04-01,1,0,4,0,0,1,ZAF
2021-05-01,2,0,1,0,0,2,ABW
2021-05-01,253,2,1,0,0,253,AGO
2021-05-01,521,1,1,14,0,535,ARE
2021-05-01,0,0,1,0,0,0,ASM
2021-05-01,0,0,1,0,0,0,ATG
2021-05-01,78,5,33,59,0,137,AUS
2021-05-01,0,0,1,5,405,5,BEL
2021-05-01,6,0,0,0,0,6,BEN
2021-05-01,0,0,1,0,0,0,BES
2021-05-01,3,3,0,0,0,3,BGD
2021-05-01,1,0,0,0,0,1,BGR
2021-05-01,8,2,1,0,0,8,BHR
2021-05-01,0,0,3,4,0,4,BHS
2021-05-01,0,0,1,0,0,0,BLZ
2021-05-01,132,17,11,51,0,183,BRA
2021-05-01,132,4,0,0,0,132,BRN
2021-05-01,0,0,9,29,0,29,CAN
2021-05-01,0,0,1,0,0,0,CHL
2021-05-01,320,66,142,471,3872,791,CHN
2021-05-01,12,1,1,0,0,12,CIV
2021-05-01,74,0,0,0,0,74,CMR
2021-05-01,50,0,0,0,0,50,COD
2021-05-01,77,0,0,0,0,77,COG
2021-05-01,5,0,3,3,0,8,COL
2021-05-01,3,0,5,3,0,6,CUB
2021-05-01,0,0,1,0,0,0,CYP
2021-05-01,22,19,2,29,1499,51,DEU
2021-05-01,0,0,1,0,0,0,DJI
2021-05-01,19,2,1,21,584,40,DNK
2021-05-01,0,0,1,0,0,0,DOM
2021-05-01,0,0,4,1,0,1,DZA
2021-05-01,12,1,2,0,0,12,ECU
2021-05-01,183,4,0,6,0,189,EGY
2021-05-01,0,0,2,2,0,2,ERI
2021-05-01,0,0,0,1,0,1,ESH
2021-05-01,2,8,0,8,0,10,ESP
2021-05-01,0,0,0,1,0,1,EST
2021-05-01,0,0,0,56,7,56,FIN
2021-05-01,0,0,3,25,0,25,FRA
2021-05-01,121,0,1,0,0,121,GAB
2021-05-01,151,15,3,25,2568,176,GBR
2021-05-01,1,0,0,1,0,2,GEO
2021-05-01,0,0,0,3,0,3,GGY
2021-05-01,3,0,6,1,0,4,GHA
2021-05-01,0,0,5,3,0,3,GIN
2021-05-01,0,0,1,14,0,14,GNB
2021-05-01,14,0,0,0,0,14,GNQ
2021-05-01,5,0,0,3,0,8,GRC
2021-05-01,0,0,0,1,0,1,GUY
2021-05-01,15,0,0,3,0,18,HRV
2021-05-01,587,75,72,196,0,783,IDN
2021-05-01,190,2,37,28,0,218,IND
2021-05-01,3,0,1,5,7,8,IRL
2021-05-01,169,4,1,2,0,171,IRN
2021-05-01,1,1,0,8,0,9,IRQ
2021-05-01,0,0,0,3,0,3,ISL
2021-05-01,4,0,1,0,0,4,ISR
2021-05-01,102,9,4,6,0,108,ITA
2021-05-01,0,0,0,1,0,1,JAM
2021-05-01,0,0,0,3,0,3,JEY
2021-05-01,21,15,47,36,0,57,JPN
2021-05-01,0,0,4,0,0,0,KEN
2021-05-01,4,0,1,7,0,11,KHM
2021-05-01,7,0,71,72,12,79,KOR
2021-05-01,34,1,0,48,0,82,KWT
2021-05-01,0,0,7,1,0,1,LBR
2021-05-01,9,0,2,0,0,9,LBY
2021-05-01,0,0,5,4,0,4,LKA
2021-05-01,1,0,0,0,0,1,LTU
2021-05-01,0,0,1,0,0,0,LVA
2021-05-01,0,0,0,1,0,1,MAR
2021-05-01,0,0,2,0,0,0,MDG
2021-05-01,216,4,11,5,0,221,MEX
2021-05-01,1,0,0,0,0,1,MLT
2021-05-01,4,5,17,11,0,15,MMR
2021-05-01,0,0,1,0,0,0,MNE
2021-05-01,2,0,1,3,0,5,MOZ
2021-05-01,0,0,1,0,0,0,MRT
2021-05-01,334,63,59,83,0,417,MYS
2021-05-01,12,0,0,0,0,12,NAM
2021-05-01,0,0,1,0,0,0,NCL
2021-05-01,433,3,7,1,0,434,NGA
2021-05-01,0,0,2,1,0,1,NIC
2021-05-01,116,13,1,12,464,128,NLD
2021-05-01,15,0,0,9,1,24,NOR
2021-05-01,8,0,1,5,0,13,NZL
2021-05-01,18,0,17,7,0,25,None
2021-05-01,9,0,4,1,0,10,OMN
2021-05-01,0,0,1,2,0,2,PAK
2021-05-01,1,0,6,7,0,8,PAN
2021-05-01,97,1,3,1,0,98,PER
2021-05-01,7,0,11,57,0,64,PHL
2021-05-01,2,0,0,2,0,4,PNG
2021-05-01,8,3,0,7,3,15,POL
2021-05-01,0,0,4,5,0,5,PRK
2021-05-01,0,0,1,1,0,1,PRT
2021-05-01,178,0,4,2,0,180,QAT
2021-05-01,9,0,0,0,0,9,ROU
2021-05-01,9,1,4,7,0,16,RUS
2021-05-01,740,21,10,1,0,741,SAU
2021-05-01,1,0,2,0,0,1,SDN
2021-05-01,3,0,0,0,0,3,SEN
2021-05-01,1,0,0,30,0,31,SGP
2021-05-01,0,0,1,0,0,0,SLB
2021-05-01,0,0,0,4,0,4,SLE
2021-05-01,0,0,0,1,0,1,SOM
2021-05-01,2,0,0,2,0,4,SUR
2021-05-01,0,0,1,46,65,46,SWE
2021-05-01,1,0,0,0,0,1,TGO
2021-05-01,406,1,25,97,0,503,THA
2021-05-01,3,0,0,0,0,3,TLS
2021-05-01,332,1,0,1,0,333,TTO
2021-05-01,13,14,1,1,0,14,TUN
2021-05-01,5,1,15,47,0,52,TUR
2021-05-01,8,7,7,0,30,8,TWN
2021-05-01,1,1,0,0,0,1,TZA
2021-05-01,13,4,3,12,0,25,UKR
2021-05-01,0,0,1,0,0,0,URY
2021-05-01,2169,43,2,705,7,2874,USA
2021-05-01,10,5,3,8,0,18,VEN
2021-05-01,43,2,22,286,175,329,VNM
2021-05-01,0,0,1,0,0,0,VUT
2021-05-01,3,0,8,2,0,5,YEM
2021-05-01,1,0,4,0,0,1,ZAF
2021-06-01,2,0,1,0,0,2,ABW
2021-06-01,251,2,1,0,0,251,AGO
2021-06-01,521,1,1,14,0,535,ARE
2021-06-01,0,0,1,0,0,0,ASM
2021-06-01,0,0,1,0,0,0,ATG
2021-06-01,76,4,32,55,0,131,AUS
2021-06-01,0,0,1,5,405,5,BEL
2021-06-01,6,0,0,0,0,6,BEN
2021-06-01,0,0,1,0,0,0,BES
2021-06-01,2,3,0,0,0,2,BGD
2021-06-01,1,0,0,0,0,1,BGR
2021-06-01,10,2,1,0,0,10,BHR
2021-06-01,0,0,3,4,0,4,BHS
2021-06-01,0,0,1,0,0,0,BLZ
2021-06-01,132,16,12,49,0,181,BRA
2021-06-01,131,4,0,0,0,131,BRN
2021-06-01,0,0,10,29,0,29,CAN
2021-06-01,0,0,1,0,0,0,CHL
2021-06-01,318,64,140,477,4048,795,CHN
2021-06-01,10,1,1,0,0,10,CIV
2021-06-01,75,0,0,0,0,75,CMR
2021-06-01,53,0,0,0,0,53,COD
2021-06-01,76,0,0,0,0,76,COG
2021-06-01,5,0,2,4,0,9,COL
2021-06-01,3,0,5,3,0,6,CUB
2021-06-01,0,0,1,0,0,0,CYP
2021-06-01,21,19,2,32,1499,53,DEU
2021-06-01,0,0,1,0,0,0,DJI
2021-06-01,19,2,1,19,584,38,DNK
2021-06-01,0,0,1,0,0,0,DOM
2021-06-01,0,0,4,1,0,1,DZA
2021-06-01,13,1,2,0,0,13,ECU
2021-06-01,185,4,0,6,0,191,EGY
2021-06-01,0,0,2,2,0,2,ERI
2021-06-01,0,0,0,1,0,1,ESH
2021-06-01,3,8,0,8,0,11,ESP
2021-06-01,0,0,0,1,0,1,EST
2021-06-01,0,0,0,56,7,56,FIN
2021-06-01,0,0,3,29,3,29,FRA
2021-06-01,124,0,1,0,0,124,GAB
2021-06-01,151,14,3,22,2488,173,GBR
2021-06-01,1,0,0,1,0,2,GEO
2021-06-01,0,0,0,3,0,3,GGY
2021-06-01,3,0,6,2,0,5,GHA
2021-06-01,0,0,5,3,0,3,GIN
2021-06-01,0,0,1,11,0,11,GNB
2021-06-01,14,0,0,0,0,14,GNQ
2021-06-01,4,0,0,3,0,7,GRC
2021-06-01,0,0,0,1,0,1,GTM
2021-06-01,0,0,0,1,0,1,GUY
2021-06-01,15,0,0,3,0,18,HRV
2021-06-01,598,87,75,166,0,764,IDN
2021-06-01,193,2,41,27,0,220,IND
2021-06-01,3,0,1,5,7,8,IRL
2021-06-01,170,4,1,2,0,172,IRN
2021-06-01,1,1,0,8,0,9,IRQ
2021-06-01,0,0,0,3,0,3,ISL
2021-06-01,4,0,1,0,0,4,ISR
2021-06-01,103,9,3,6,0,109,ITA
2021-06-01,0,0,0,1,0,1,JAM
2021-06-01,0,0,0,5,0,5,JEY
2021-06-01,23,14,51,40,0,63,JPN
2021-06-01,0,0,4,0,0,0,KEN
2021-06-01,4,0,2,6,0,10,KHM
2021-06-01,7,0,74,64,12,71,KOR
2021-06-01,33,4,0,48,0,81,KWT
2021-06-01,0,0,7,1,0,1,LBR
2021-06-01,9,0,2,0,0,9,LBY
2021-06-01,0,0,4,4,0,4,LKA
2021-06-01,1,0,0,0,0,1,LTU
2021-06-01,0,0,1,0,0,0,LVA
2021-06-01,0,0,0,1,0,1,MAR
2021-06-01,0,0,1,0,0,0,MDG
2021-06-01,215,4,11,5,0,220,MEX
2021-06-01,1,0,0,0,0,1,MLT
2021-06-01,5,4,17,10,0,15,MMR
2021-06-01,0,0,1,0,0,0,MNE
2021-06-01,2,0,1,3,0,5,MOZ
2021-06-01,0,0,1,0,0,0,MRT
2021-06-01,335,57,55,77,0,412,MYS
2021-06-01,12,0,0,0,0,12,NAM
2021-06-01,0,0,1,0,0,0,NCL
2021-06-01,300,3,6,2,0,302,NGA
2021-06-01,0,0,3,1,0,1,NIC
2021-06-01,115,14,1,11,464,126,NLD
2021-06-01,14,0,0,9,1,23,NOR
2021-06-01,7,0,1,5,0,12,NZL
2021-06-01,19,0,19,9,0,28,None
2021-06-01,9,0,3,2,0,11,OMN
2021-06-01,0,0,1,1,0,1,PAK
2021-06-01,0,0,5,6,0,6,PAN
2021-06-01,97,1,3,1,0,98,PER
2021-06-01,8,0,9,49,0,57,PHL
2021-06-01,2,0,0,3,0,5,PNG
2021-06-01,8,3,0,9,3,17,POL
2021-06-01,0,0,4,5,0,5,PRK
2021-06-01,0,0,1,1,0,1,PRT
2021-06-01,181,0,4,2,0,183,QAT
2021-06-01,9,0,0,0,0,9,ROU
2021-06-01,7,2,5,8,0,15,RUS
2021-06-01,754,21,9,1,0,755,SAU
2021-06-01,1,1,2,0,0,1,SDN
2021-06-01,2,0,0,0,0,2,SEN
2021-06-01,1,0,0,27,0,28,SGP
2021-06-01,0,0,1,0,0,0,SLB
2021-06-01,0,0,0,4,0,4,SLE
2021-06-01,0,0,0,1,0,1,SOM
2021-06-01,3,0,0,0,0,3,SUR
2021-06-01,0,0,1,47,65,47,SWE
2021-06-01,1,0,0,0,0,1,TGO
2021-06-01,407,1,22,90,0,497,THA
2021-06-01,3,0,0,0,0,3,TLS
2021-06-01,329,1,0,1,0,330,TTO
2021-06-01,13,14,1,2,0,15,TUN
2021-06-01,6,1,14,46,0,52,TUR
2021-06-01,9,7,6,0,33,9,TWN
2021-06-01,1,1,0,0,0,1,TZA
2021-06-01,13,4,3,13,0,26,UKR
2021-06-01,0,0,1,0,0,0,URY
2021-06-01,2170,44,2,711,7,2881,USA
2021-06-01,12,5,3,7,0,19,VEN
2021-06-01,43,2,22,289,203,332,VNM
2021-06-01,0,0,1,0,0,0,VUT
2021-06-01,3,0,7,1,0,4,YEM
2021-06-01,1,0,4,0,0,1,ZAF
2021-07-01,2,0,1,0,0,2,ABW
2021-07-01,120,2,1,0,0,120,AGO
2021-07-01,523,1,1,11,0,534,ARE
2021-07-01,0,0,1,0,0,0,ASM
2021-07-01,0,0,1,0,0,0,ATG
2021-07-01,75,4,33,55,0,130,AUS
2021-07-01,0,0,1,5,405,5,BEL
2021-07-01,6,0,0,0,0,6,BEN
2021-07-01,0,0,1,0,0,0,BES
2021-07-01,2,4,0,0,0,2,BGD
2021-07-01,1,0,0,0,0,1,BGR
2021-07-01,10,2,1,0,0,10,BHR
2021-07-01,0,0,3,4,0,4,BHS
2021-07-01,0,0,1,0,0,0,BLZ
2021-07-01,132,16,12,47,0,179,BRA
2021-07-01,129,4,0,0,0,129,BRN
2021-07-01,0,0,10,30,0,30,CAN
2021-07-01,0,0,1,0,0,0,CHL
2021-07-01,314,64,141,485,4309,799,CHN
2021-07-01,10,1,0,0,0,10,CIV
2021-07-01,73,0,0,0,0,73,CMR
2021-07-01,52,0,0,0,0,52,COD
2021-07-01,60,0,0,0,0,60,COG
2021-07-01,5,0,1,4,0,9,COL
2021-07-01,3,0,5,1,0,4,CUB
2021-07-01,0,0,1,0,0,0,CYP
2021-07-01,21,19,2,32,1501,53,DEU
2021-07-01,0,0,1,0,0,0,DJI
2021-07-01,17,2,1,18,584,35,DNK
2021-07-01,0,0,1,0,0,0,DOM
2021-07-01,0,0,4,0,0,0,DZA
2021-07-01,14,1,2,0,0,14,ECU
2021-07-01,187,4,0,7,0,194,EGY
2021-07-01,0,0,2,2,0,2,ERI
2021-07-01,0,0,0,1,0,1,ESH
2021-07-01,3,7,0,8,0,11,ESP
2021-07-01,0,0,0,1,0,1,EST
2021-07-01,0,0,0,52,6,52,FIN
2021-07-01,0,0,3,27,7,27,FRA
2021-07-01,123,0,1,0,0,123,GAB
2021-07-01,157,18,2,25,2496,182,GBR
2021-07-01,1,0,0,1,0,2,GEO
2021-07-01,0,0,0,1,0,1,GGY
2021-07-01,3,0,4,2,0,5,GHA
2021-07-01,0,0,3,2,0,2,GIN
2021-07-01,0,0,3,8,0,8,GNB
2021-07-01,14,0,0,0,0,14,GNQ
2021-07-01,4,0,0,3,0,7,GRC
2021-07-01,0,0,0,1,0,1,GTM
2021-07-01,0,0,0,1,0,1,GUY
2021-07-01,15,0,0,3,0,18,HRV
2021-07-01,608,96,76,174,0,782,IDN
2021-07-01,193,2,38,32,0,225,IND
2021-07-01,3,0,1,4,7,7,IRL
2021-07-01,172,2,1,1,0,173,IRN
2021-07-01,1,1,0,9,0,10,IRQ
2021-07-01,0,0,0,3,0,3,ISL
2021-07-01,4,0,1,0,0,4,ISR
2021-07-01,103,9,3,5,0,108,ITA
2021-07-01,0,0,0,1,0,1,JAM
2021-07-01,0,0,0,5,0,5,JEY
2021-07-01,22,15,53,43,0,65,JPN
2021-07-01,0,0,4,0,0,0,KEN
2021-07-01,4,0,2,6,0,10,KHM
2021-07-01,7,0,76,69,12,76,KOR
2021-07-01,32,5,0,40,0,72,KWT
2021-07-01,0,0,4,0,0,0,LBR
2021-07-01,10,0,2,0,0,10,LBY
2021-07-01,0,0,5,5,0,5,LKA
2021-07-01,1,0,0,0,0,1,LTU
2021-07-01,0,0,1,0,0,0,LVA
2021-07-01,0,0,0,2,0,2,MAR
2021-07-01,0,0,1,0,0,0,MDG
2021-07-01,216,3,11,4,0,220,MEX
2021-07-01,1,0,0,0,0,1,MLT
2021-07-01,5,4,17,10,0,15,MMR
2021-07-01,0,0,1,0,0,0,MNE
2021-07-01,2,0,3,2,0,4,MOZ
2021-07-01,0,0,1,0,0,0,MRT
2021-07-01,333,59,57,81,0,414,MYS
2021-07-01,11,0,0,0,0,11,NAM
2021-07-01,0,0,1,0,0,0,NCL
2021-07-01,299,3,6,2,0,301,NGA
2021-07-01,0,0,3,1,0,1,NIC
2021-07-01,113,13,1,13,464,126,NLD
2021-07-01,13,0,0,9,1,22,NOR
2021-07-01,7,0,1,5,0,12,NZL
2021-07-01,19,0,18,9,0,28,None
2021-07-01,9,0,3,2,0,11,OMN
2021-07-01,0,0,1,0,0,0,PAK
2021-07-01,0,0,4,5,0,5,PAN
2021-07-01,98,1,3,0,0,98,PER
2021-07-01,8,0,8,52,0,60,PHL
2021-07-01,2,0,0,2,0,4,PNG
2021-07-01,9,3,0,9,3,18,POL
2021-07-01,0,0,2,3,0,3,PRK
2021-07-01,0,0,0,1,0,1,PRT
2021-07-01,181,0,4,2,0,183,QAT
2021-07-01,9,0,0,0,0,9,ROU
2021-07-01,7,2,4,8,0,15,RUS
2021-07-01,757,22,9,1,0,758,SAU
2021-07-01,1,1,2,0,0,1,SDN
2021-07-01,0,0,3,0,0,0,SEN
2021-07-01,1,0,0,29,0,30,SGP
2021-07-01,0,0,1,0,0,0,SLB
2021-07-01,0,0,0,5,0,5,SLE
2021-07-01,0,0,0,1,0,1,SOM
2021-07-01,2,0,0,0,0,2,SUR
2021-07-01,0,0,1,48,65,48,SWE
2021-07-01,410,1,21,97,0,507,THA
2021-07-01,3,0,0,0,0,3,TLS
2021-07-01,331,1,0,1,0,332,TTO
2021-07-01,13,14,1,2,0,15,TUN
2021-07-01,6,1,15,47,0,53,TUR
2021-07-01,11,8,5,0,35,11,TWN
2021-07-01,1,1,0,0,0,1,TZA
2021-07-01,13,4,3,12,0,25,UKR
2021-07-01,0,0,1,0,0,0,URY
2021-07-01,2181,46,2,713,7,2894,USA
2021-07-01,11,4,3,6,0,17,VEN
2021-07-01,44,3,25,290,228,334,VNM
2021-07-01,0,0,1,0,0,0,VUT
2021-07-01,3,0,8,1,0,4,YEM
2021-07-01,1,0,5,0,0,1,ZAF
2021-08-01,2,0,1,0,0,2,ABW
2021-08-01,121,1,0,0,0,121,AGO
2021-08-01,524,1,1,17,0,541,ARE
2021-08-01,0,0,1,0,0,0,ASM
2021-08-01,0,0,1,0,0,0,ATG
2021-08-01,72,4,29,54,0,126,AUS
2021-08-01,0,0,1,5,405,5,BEL
2021-08-01,6,0,0,0,0,6,BEN
2021-08-01,0,0,1,0,0,0,BES
2021-08-01,2,4,0,0,0,2,BGD
2021-08-01,1,0,0,0,0,1,BGR
2021-08-01,10,2,1,0,0,10,BHR
2021-08-01,0,0,3,4,0,4,BHS
2021-08-01,133,15,12,48,0,181,BRA
2021-08-01,131,4,0,0,0,131,BRN
2021-08-01,0,0,10,31,0,31,CAN
2021-08-01,313,62,139,502,4479,815,CHN
2021-08-01,11,1,0,0,0,11,CIV
2021-08-01,72,0,0,0,0,72,CMR
2021-08-01,51,0,0,0,0,51,COD
2021-08-01,59,0,0,0,0,59,COG
2021-08-01,5,0,2,3,0,8,COL
2021-08-01,3,0,5,1,0,4,CUB
2021-08-01,0,0,1,0,0,0,CYP
2021-08-01,21,19,2,32,1501,53,DEU
2021-08-01,0,0,1,0,0,0,DJI
2021-08-01,16,2,1,18,584,34,DNK
2021-08-01,0,0,2,0,0,0,DOM
2021-08-01,0,0,5,0,0,0,DZA
2021-08-01,15,1,2,0,0,15,ECU
2021-08-01,188,5,0,7,0,195,EGY
2021-08-01,0,0,2,2,0,2,ERI
2021-08-01,0,0,0,1,0,1,ESH
2021-08-01,3,6,0,7,0,10,ESP
2021-08-01,0,0,0,1,0,1,EST
2021-08-01,0,0,0,54,6,54,FIN
2021-08-01,0,0,2,23,16,23,FRA
2021-08-01,121,0,1,0,0,121,GAB
2021-08-01,153,18,2,25,2625,178,GBR
2021-08-01,1,0,0,0,0,1,GEO
2021-08-01,0,0,0,1,0,1,GGY
2021-08-01,3,0,4,2,0,5,GHA
2021-08-01,0,0,3,1,0,1,GIN
2021-08-01,0,0,0,1,0,1,GLP
2021-08-01,0,0,3,9,0,9,GNB
2021-08-01,14,0,0,0,0,14,GNQ
2021-08-01,5,0,0,3,0,8,GRC
2021-08-01,0,0,0,1,0,1,GTM
2021-08-01,0,0,0,1,0,1,GUY
2021-08-01,15,0,0,3,0,18,HRV
2021-08-01,603,103,87,200,0,803,IDN
2021-08-01,191,3,38,31,0,222,IND
2021-08-01,3,0,1,3,7,6,IRL
2021-08-01,174,3,1,1,0,175,IRN
2021-08-01,1,1,0,9,0,10,IRQ
2021-08-01,0,0,0,4,0,4,ISL
2021-08-01,4,0,2,0,0,4,ISR
2021-08-01,104,9,3,6,0,110,ITA
2021-08-01,0,0,1,1,0,1,JAM
2021-08-01,0,0,0,5,0,5,JEY
2021-08-01,26,17,51,43,0,69,JPN
2021-08-01,0,0,4,1,0,1,KEN
2021-08-01,4,0,1,6,0,10,KHM
2021-08-01,7,0,76,76,12,83,KOR
2021-08-01,32,4,0,41,0,73,KWT
2021-08-01,0,0,4,0,0,0,LBR
2021-08-01,10,0,2,0,0,10,LBY
2021-08-01,0,0,5,5,0,5,LKA
2021-08-01,1,0,0,0,0,1,LTU
2021-08-01,0,0,1,0,0,0,LVA
2021-08-01,0,0,0,2,0,2,MAR
2021-08-01,0,0,1,0,0,0,MDG
2021-08-01,218,2,11,4,0,222,MEX
2021-08-01,1,0,0,0,0,1,MLT
2021-08-01,4,4,17,10,0,14,MMR
2021-08-01,0,0,1,0,0,0,MNE
2021-08-01,3,0,3,2,0,5,MOZ
2021-08-01,0,0,1,0,0,0,MRT
2021-08-01,332,63,53,84,0,416,MYS
2021-08-01,10,0,0,0,0,10,NAM
2021-08-01,424,5,6,3,0,427,NGA
2021-08-01,0,0,3,1,0,1,NIC
2021-08-01,112,13,1,13,472,125,NLD
2021-08-01,14,0,0,9,1,23,NOR
2021-08-01,7,0,1,6,0,13,NZL
2021-08-01,17,0,17,8,0,25,None
2021-08-01,9,0,2,2,0,11,OMN
2021-08-01,0,0,1,1,0,1,PAK
2021-08-01,0,0,4,6,0,6,PAN
2021-08-01,98,1,3,0,0,98,PER
2021-08-01,7,0,9,58,0,65,PHL
2021-08-01,2,0,0,2,0,4,PNG
2021-08-01,9,3,0,7,3,16,POL
2021-08-01,0,0,2,3,0,3,PRK
2021-08-01,0,0,0,1,0,1,PRT
2021-08-01,178,0,4,1,0,179,QAT
2021-08-01,9,0,0,0,0,9,ROU
2021-08-01,8,2,4,11,0,19,RUS
2021-08-01,764,22,11,1,0,765,SAU
2021-08-01,1,1,2,0,0,1,SDN
2021-08-01,0,0,3,0,0,0,SEN
2021-08-01,0,0,0,27,0,27,SGP
2021-08-01,0,0,1,0,0,0,SLB
2021-08-01,0,0,0,6,0,6,SLE
2021-08-01,0,0,0,1,0,1,SOM
2021-08-01,2,0,1,0,0,2,SUR
2021-08-01,0,0,1,50,65,50,SWE
2021-08-01,411,1,18,99,0,510,THA
2021-08-01,3,0,0,0,0,3,TLS
2021-08-01,324,1,1,1,0,325,TTO
2021-08-01,13,14,1,2,0,15,TUN
2021-08-01,6,1,15,49,0,55,TUR
2021-08-01,11,9,5,0,35,11,TWN
2021-08-01,1,1,0,0,0,1,TZA
2021-08-01,14,4,3,12,0,26,UKR
2021-08-01,0,0,1,0,0,0,URY
2021-08-01,2156,45,3,696,7,2852,USA
2021-08-01,13,4,3,5,0,18,VEN
2021-08-01,45,3,26,294,265,339,VNM
2021-08-01,0,0,1,0,0,0,VUT
2021-08-01,3,0,9,1,0,4,YEM
2021-08-01,1,0,5,0,0,1,ZAF
2021-09-01,2,0,1,0,0,2,ABW
2021-09-01,118,1,0,0,0,118,AGO
2021-09-01,520,1,1,19,0,539,ARE
2021-09-01,0,0,1,0,0,0,ASM
2021-09-01,0,0,1,0,0,0,ATG
2021-09-01,70,4,31,50,0,120,AUS
2021-09-01,0,0,1,5,405,5,BEL
2021-09-01,6,0,0,0,0,6,BEN
2021-09-01,0,0,1,0,0,0,BES
2021-09-01,2,3,0,0,0,2,BGD
2021-09-01,1,0,0,0,0,1,BGR
2021-09-01,10,2,1,0,0,10,BHR
2021-09-01,0,0,3,4,0,4,BHS
2021-09-01,136,14,13,51,0,187,BRA
2021-09-01,131,4,0,0,0,131,BRN
2021-09-01,0,0,10,33,0,33,CAN
2021-09-01,316,59,137,500,4666,816,CHN
2021-09-01,11,1,0,0,0,11,CIV
2021-09-01,73,0,0,0,0,73,CMR
2021-09-01,51,0,0,0,0,51,COD
2021-09-01,59,0,0,0,0,59,COG
2021-09-01,5,0,3,3,0,8,COL
2021-09-01,3,0,5,1,0,4,CUB
2021-09-01,0,0,1,0,0,0,CYP
2021-09-01,20,18,2,28,1501,48,DEU
2021-09-01,0,0,1,0,0,0,DJI
2021-09-01,16,2,0,19,584,35,DNK
2021-09-01,0,0,2,0,0,0,DOM
2021-09-01,0,0,5,0,0,0,DZA
2021-09-01,16,1,2,0,0,16,ECU
2021-09-01,187,5,0,6,0,193,EGY
2021-09-01,0,0,2,2,0,2,ERI
2021-09-01,0,0,0,1,0,1,ESH
2021-09-01,3,6,0,7,0,10,ESP
2021-09-01,0,0,0,1,0,1,EST
2021-09-01,0,0,0,56,6,56,FIN
2021-09-01,0,0,2,23,25,23,FRA
2021-09-01,119,0,1,0,0,119,GAB
2021-09-01,156,14,2,20,2643,176,GBR
2021-09-01,1,0,0,0,0,1,GEO
2021-09-01,0,0,0,2,0,2,GGY
2021-09-01,3,0,3,1,0,4,GHA
2021-09-01,0,0,3,2,0,2,GIN
2021-09-01,0,0,0,1,0,1,GLP
2021-09-01,0,0,3,9,0,9,GNB
2021-09-01,13,0,0,0,0,13,GNQ
2021-09-01,5,0,0,3,0,8,GRC
2021-09-01,0,0,0,1,0,1,GTM
2021-09-01,0,0,1,1,0,1,GUY
2021-09-01,15,0,0,3,0,18,HRV
2021-09-01,599,103,92,213,0,812,IDN
2021-09-01,192,3,40,30,0,222,IND
2021-09-01,3,0,1,3,7,6,IRL
2021-09-01,179,2,1,1,0,180,IRN
2021-09-01,1,1,1,9,0,10,IRQ
2021-09-01,0,0,0,4,0,4,ISL
2021-09-01,4,0,2,0,0,4,ISR
2021-09-01,104,9,3,6,0,110,ITA
2021-09-01,0,0,1,1,0,1,JAM
2021-09-01,0,0,1,6,0,6,JEY
2021-09-01,25,18,50,46,0,71,JPN
2021-09-01,0,0,4,1,0,1,KEN
2021-09-01,4,0,1,8,0,12,KHM
2021-09-01,7,0,78,74,12,81,KOR
2021-09-01,34,2,0,52,0,86,KWT
2021-09-01,0,0,3,0,0,0,LBR
2021-09-01,10,0,1,0,0,10,LBY
2021-09-01,0,0,5,5,0,5,LKA
2021-09-01,1,0,0,0,0,1,LTU
2021-09-01,0,0,1,0,0,0,LVA
2021-09-01,0,0,0,2,0,2,MAR
2021-09-01,0,0,1,0,0,0,MDG
2021-09-01,219,3,10,6,0,225,MEX
2021-09-01,1,0,0,0,0,1,MLT
2021-09-01,4,3,18,9,0,13,MMR
2021-09-01,0,0,1,0,0,0,MNE
2021-09-01,3,0,3,3,0,6,MOZ
2021-09-01,330,63,53,79,0,409,MYS
2021-09-01,11,0,0,0,0,11,NAM
2021-09-01,425,5,7,3,0,428,NGA
2021-09-01,0,0,2,1,0,1,NIC
2021-09-01,113,10,1,12,482,125,NLD
2021-09-01,14,0,0,8,2,22,NOR
2021-09-01,6,0,1,6,0,12,NZL
2021-09-01,16,0,15,8,0,24,None
2021-09-01,9,0,2,2,0,11,OMN
2021-09-01,0,0,1,1,0,1,PAK
2021-09-01,0,0,4,6,0,6,PAN
2021-09-01,99,1,2,1,0,100,PER
2021-09-01,7,0,9,62,0,69,PHL
2021-09-01,2,0,0,3,0,5,PNG
2021-09-01,9,3,0,9,3,18,POL
2021-09-01,0,0,2,2,0,2,PRK
2021-09-01,0,0,0,1,0,1,PRT
2021-09-01,177,0,3,2,0,179,QAT
2021-09-01,9,0,0,0,0,9,ROU
2021-09-01,8,1,5,11,0,19,RUS
2021-09-01,758,23,11,2,0,760,SAU
2021-09-01,1,1,2,0,0,1,SDN
2021-09-01,1,0,3,0,0,1,SEN
2021-09-01,0,0,0,27,0,27,SGP
2021-09-01,0,0,1,0,0,0,SLB
2021-09-01,0,0,0,5,0,5,SLE
2021-09-01,0,0,0,1,0,1,SOM
2021-09-01,2,0,3,0,0,2,SUR
2021-09-01,0,0,1,50,65,50,SWE
2021-09-01,411,1,18,98,0,509,THA
2021-09-01,3,0,0,0,0,3,TLS
2021-09-01,326,1,1,1,0,327,TTO
2021-09-01,14,14,1,2,0,16,TUN
2021-09-01,6,1,15,49,0,55,TUR
2021-09-01,15,15,5,0,35,15,TWN
2021-09-01,1,1,0,0,0,1,TZA
2021-09-01,14,4,3,11,0,25,UKR
2021-09-01,0,0,1,0,0,0,URY
2021-09-01,2140,45,3,684,7,2824,USA
2021-09-01,13,3,2,6,0,19,VEN
2021-09-01,44,2,27,302,271,346,VNM
2021-09-01,0,0,1,0,0,0,VUT
2021-09-01,3,0,9,1,0,4,YEM
2021-09-01,1,0,5,0,0,1,ZAF
2021-10-01,2,0,1,0,0,2,ABW
2021-10-01,118,1,0,0,0,118,AGO
2021-10-01,518,1,1,17,0,535,ARE
2021-10-01,0,0,1,0,0,0,ASM
2021-10-01,0,0,1,0,0,0,ATG
2021-10-01,70,4,33,48,0,118,AUS
2021-10-01,0,0,1,5,405,5,BEL
2021-10-01,6,0,0,0,0,6,BEN
2021-10-01,0,0,1,0,0,0,BES
2021-10-01,3,3,0,0,0,3,BGD
2021-10-01,1,0,0,0,0,1,BGR
2021-10-01,10,2,1,0,0,10,BHR
2021-10-01,0,0,2,4,0,4,BHS
2021-10-01,138,15,13,51,0,189,BRA
2021-10-01,131,4,0,0,0,131,BRN
2021-10-01,0,0,8,32,0,32,CAN
2021-10-01,316,55,137,492,4746,808,CHN
2021-10-01,11,1,1,0,0,11,CIV
2021-10-01,75,0,0,0,0,75,CMR
2021-10-01,49,0,0,0,0,49,COD
2021-10-01,59,0,0,0,0,59,COG
2021-10-01,5,0,3,3,0,8,COL
2021-10-01,3,0,5,1,0,4,CUB
2021-10-01,0,0,1,0,0,0,CYP
2021-10-01,20,18,2,28,1503,48,DEU
2021-10-01,0,0,1,0,0,0,DJI
2021-10-01,15,3,0,19,584,34,DNK
2021-10-01,0,0,2,0,0,0,DOM
2021-10-01,0,0,4,0,0,0,DZA
2021-10-01,16,1,2,0,0,16,ECU
2021-10-01,190,5,0,6,0,196,EGY
2021-10-01,0,0,2,1,0,1,ERI
2021-10-01,0,0,0,1,0,1,ESH
2021-10-01,3,6,0,7,0,10,ESP
2021-10-01,0,0,0,1,0,1,EST
2021-10-01,0,0,0,55,6,55,FIN
2021-10-01,0,0,5,24,28,24,FRA
2021-10-01,121,0,1,0,0,121,GAB
2021-10-01,157,13,3,18,2644,175,GBR
2021-10-01,1,0,0,0,0,1,GEO
2021-10-01,0,0,0,2,0,2,GGY
2021-10-01,3,0,3,2,0,5,GHA
2021-10-01,0,0,3,3,0,3,GIN
2021-10-01,0,0,0,2,0,2,GLP
2021-10-01,0,0,3,8,0,8,GNB
2021-10-01,14,0,0,0,0,14,GNQ
2021-10-01,5,0,0,3,0,8,GRC
2021-10-01,0,0,0,1,0,1,GTM
2021-10-01,0,0,1,1,0,1,GUY
2021-10-01,15,0,0,3,0,18,HRV
2021-10-01,599,98,86,202,0,801,IDN
2021-10-01,192,3,38,29,0,221,IND
2021-10-01,3,0,1,3,7,6,IRL
2021-10-01,180,2,1,2,0,182,IRN
2021-10-01,1,1,1,9,0,10,IRQ
2021-10-01,0,0,0,4,0,4,ISL
2021-10-01,4,0,1,0,0,4,ISR
2021-10-01,105,9,3,8,0,113,ITA
2021-10-01,0,0,1,1,0,1,JAM
2021-10-01,0,0,1,3,0,3,JEY
2021-10-01,26,15,49,46,0,72,JPN
2021-10-01,0,0,4,1,0,1,KEN
2021-10-01,4,0,1,8,0,12,KHM
2021-10-01,7,0,77,66,12,73,KOR
2021-10-01,35,2,0,56,0,91,KWT
2021-10-01,0,0,3,0,0,0,LBR
2021-10-01,11,0,1,0,0,11,LBY
2021-10-01,0,0,4,4,0,4,LKA
2021-10-01,1,0,0,0,0,1,LTU
2021-10-01,0,0,1,0,0,0,LVA
2021-10-01,0,0,0,2,0,2,MAR
2021-10-01,0,0,1,0,0,0,MDG
2021-10-01,215,3,12,6,0,221,MEX
2021-10-01,1,0,0,0,0,1,MLT
2021-10-01,5,3,17,9,0,14,MMR
2021-10-01,0,0,1,0,0,0,MNE
2021-10-01,3,0,3,3,0,6,MOZ
2021-10-01,328,61,50,78,0,406,MYS
2021-10-01,11,0,0,0,0,11,NAM
2021-10-01,431,5,7,3,0,434,NGA
2021-10-01,0,0,2,1,0,1,NIC
2021-10-01,113,10,1,10,485,123,NLD
2021-10-01,15,0,0,8,2,23,NOR
2021-10-01,6,0,1,6,0,12,NZL
2021-10-01,18,0,13,7,0,25,None
2021-10-01,8,0,2,2,0,10,OMN
2021-10-01,0,0,1,1,0,1,PAK
2021-10-01,0,0,4,4,0,4,PAN
2021-10-01,96,2,2,1,0,97,PER
2021-10-01,7,0,9,57,0,64,PHL
2021-10-01,2,0,0,3,0,5,PNG
2021-10-01,9,3,0,9,3,18,POL
2021-10-01,0,0,3,2,0,2,PRK
2021-10-01,0,0,0,1,0,1,PRT
2021-10-01,178,0,3,5,0,183,QAT
2021-10-01,9,0,0,0,0,9,ROU
2021-10-01,9,1,7,11,0,20,RUS
2021-10-01,755,26,11,2,0,757,SAU
2021-10-01,1,1,2,0,0,1,SDN
2021-10-01,1,0,3,0,0,1,SEN
2021-10-01,0,0,0,34,0,34,SGP
2021-10-01,0,0,1,0,0,0,SLB
2021-10-01,0,0,0,5,0,5,SLE
2021-10-01,0,0,0,1,0,1,SOM
2021-10-01,2,0,3,0,0,2,SUR
2021-10-01,0,0,1,46,65,46,SWE
2021-10-01,412,1,18,97,0,509,THA
2021-10-01,3,0,0,0,0,3,TLS
2021-10-01,329,1,1,1,0,330,TTO
2021-10-01,14,14,1,2,0,16,TUN
2021-10-01,6,1,15,51,0,57,TUR
2021-10-01,15,15,5,0,35,15,TWN
2021-10-01,1,1,0,0,0,1,TZA
2021-10-01,14,4,3,10,0,24,UKR
2021-10-01,0,0,1,0,0,0,URY
2021-10-01,2126,45,3,676,7,2802,USA
2021-10-01,13,2,2,6,0,19,VEN
2021-10-01,45,2,27,303,272,348,VNM
2021-10-01,0,0,1,0,0,0,VUT
2021-10-01,3,0,9,1,0,4,YEM
2021-10-01,1,0,5,0,0,1,ZAF
2021-11-01,2,0,1,0,0,2,ABW
2021-11-01,245,1,0,0,0,245,AGO
2021-11-01,520,0,1,12,0,532,ARE
2021-11-01,0,0,1,0,0,0,ASM
2021-11-01,0,0,1,0,0,0,ATG
2021-11-01,75,5,35,43,0,118,AUS
2021-11-01,0,0,1,5,405,5,BEL
2021-11-01,6,0,0,0,0,6,BEN
2021-11-01,0,0,1,0,0,0,BES
2021-11-01,3,2,0,0,0,3,BGD
2021-11-01,1,0,0,0,0,1,BGR
2021-11-01,9,2,1,0,0,9,BHR
2021-11-01,0,0,2,5,0,5,BHS
2021-11-01,133,14,13,44,0,177,BRA
2021-11-01,130,4,0,0,0,130,BRN
2021-11-01,0,0,7,29,0,29,CAN
2021-11-01,0,0,1,0,0,0,CHL
2021-11-01,320,60,146,497,4931,817,CHN
2021-11-01,10,1,1,0,0,10,CIV
2021-11-01,75,0,0,0,0,75,CMR
2021-11-01,49,0,0,0,0,49,COD
2021-11-01,77,0,0,0,0,77,COG
2021-11-01,5,0,3,5,0,10,COL
2021-11-01,3,0,5,1,0,4,CUB
2021-11-01,0,0,1,0,0,0,CYP
2021-11-01,21,19,2,27,1502,48,DEU
2021-11-01,0,0,1,0,0,0,DJI
2021-11-01,13,3,0,18,584,31,DNK
2021-11-01,0,0,1,0,0,0,DOM
2021-11-01,0,0,4,0,0,0,DZA
2021-11-01,13,1,2,0,0,13,ECU
2021-11-01,190,4,0,5,0,195,EGY
2021-11-01,0,0,2,1,0,1,ERI
2021-11-01,3,6,0,7,0,10,ESP
2021-11-01,0,0,0,1,0,1,EST
2021-11-01,0,0,0,52,6,52,FIN
2021-11-01,0,0,5,23,36,23,FRA
2021-11-01,123,0,1,1,0,124,GAB
2021-11-01,152,12,3,15,2664,167,GBR
2021-11-01,1,0,0,0,0,1,GEO
2021-11-01,0,0,0,2,0,2,GGY
2021-11-01,3,0,4,2,0,5,GHA
2021-11-01,0,0,3,2,0,2,GIN
2021-11-01,0,0,0,2,0,2,GLP
2021-11-01,0,0,3,7,0,7,GNB
2021-11-01,14,0,0,0,0,14,GNQ
2021-11-01,5,0,0,2,0,7,GRC
2021-11-01,0,0,1,1,0,1,GUY
2021-11-01,15,0,0,3,0,18,HRV
2021-11-01,375,83,76,200,0,575,IDN
2021-11-01,189,3,36,27,0,216,IND
2021-11-01,3,0,1,4,7,7,IRL
2021-11-01,177,4,1,3,0,180,IRN
2021-11-01,1,1,1,10,0,11,IRQ
2021-11-01,0,0,0,5,0,5,ISL
2021-11-01,4,0,1,0,0,4,ISR
2021-11-01,105,9,3,9,0,114,ITA
2021-11-01,0,0,1,1,0,1,JAM
2021-11-01,26,16,49,44,0,70,JPN
2021-11-01,0,0,4,1,0,1,KEN
2021-11-01,4,0,1,6,0,10,KHM
2021-11-01,7,0,81,60,12,67,KOR
2021-11-01,33,4,0,47,0,80,KWT
2021-11-01,0,0,7,1,0,1,LBR
2021-11-01,11,0,1,0,0,11,LBY
2021-11-01,0,0,4,4,0,4,LKA
2021-11-01,1,0,0,0,0,1,LTU
2021-11-01,0,0,1,0,0,0,LVA
2021-11-01,0,0,0,1,0,1,MAR
2021-11-01,0,0,1,0,0,0,MDG
2021-11-01,215,2,12,6,0,221,MEX
2021-11-01,1,0,0,0,0,1,MLT
2021-11-01,5,2,16,12,0,17,MMR
2021-11-01,0,0,1,0,0,0,MNE
2021-11-01,2,0,2,2,0,4,MOZ
2021-11-01,333,65,46,81,0,414,MYS
2021-11-01,9,0,0,0,0,9,NAM
2021-11-01,436,5,6,2,0,438,NGA
2021-11-01,0,0,2,1,0,1,NIC
2021-11-01,113,10,1,9,486,122,NLD
2021-11-01,14,0,0,9,2,23,NOR
2021-11-01,6,0,1,6,0,12,NZL
2021-11-01,16,0,14,5,0,21,None
2021-11-01,8,0,2,2,0,10,OMN
2021-11-01,0,0,1,1,0,1,PAK
2021-11-01,0,0,6,4,0,4,PAN
2021-11-01,98,2,2,1,0,99,PER
2021-11-01,7,0,10,48,0,55,PHL
2021-11-01,2,0,0,3,0,5,PNG
2021-11-01,9,3,0,9,3,18,POL
2021-11-01,0,0,5,2,0,2,PRK
2021-11-01,0,0,0,1,0,1,PRT
2021-11-01,179,0,3,5,0,184,QAT
2021-11-01,9,0,0,0,0,9,ROU
2021-11-01,9,1,7,8,0,17,RUS
2021-11-01,759,22,10,1,0,760,SAU
2021-11-01,1,1,2,0,0,1,SDN
2021-11-01,2,0,2,0,0,2,SEN
2021-11-01,0,0,0,34,0,34,SGP
2021-11-01,0,0,1,0,0,0,SLB
2021-11-01,0,0,0,5,0,5,SLE
2021-11-01,0,0,0,1,0,1,SOM
2021-11-01,0,0,2,0,0,0,SUR
2021-11-01,0,0,1,42,65,42,SWE
2021-11-01,416,1,14,90,0,506,THA
2021-11-01,4,0,0,0,0,4,TLS
2021-11-01,328,1,1,1,0,329,TTO
2021-11-01,14,15,1,2,0,16,TUN
2021-11-01,6,1,15,52,0,58,TUR
2021-11-01,18,19,3,0,35,18,TWN
2021-11-01,1,0,1,0,0,1,TZA
2021-11-01,14,4,3,10,0,24,UKR
2021-11-01,0,0,1,0,0,0,URY
2021-11-01,2121,41,3,675,7,2796,USA
2021-11-01,14,3,4,7,0,21,VEN
2021-11-01,44,1,26,298,278,342,VNM
2021-11-01,0,0,1,0,0,0,VUT
2021-11-01,3,0,10,3,0,6,YEM
2021-11-01,1,0,6,0,0,1,ZAF
2021-12-01,2,0,1,0,0,2,ABW
2021-12-01,246,1,0,0,0,246,AGO
2021-12-01,521,0,1,12,0,533,ARE
2021-12-01,0,0,1,0,0,0,ASM
2021-12-01,0,0,1,0,0,0,ATG
2021-12-01,76,4,36,44,0,120,AUS
2021-12-01,0,0,1,5,405,5,BEL
2021-12-01,6,0,0,0,0,6,BEN
2021-12-01,0,0,1,0,0,0,BES
2021-12-01,3,2,0,0,0,3,BGD
2021-12-01,1,0,0,0,0,1,BGR
2021-12-01,8,2,1,0,0,8,BHR
2021-12-01,0,0,2,5,0,5,BHS
2021-12-01,131,14,14,40,0,171,BRA
2021-12-01,132,4,0,0,0,132,BRN
2021-12-01,0,0,7,24,0,24,CAN
2021-12-01,0,0,2,0,0,0,CHL
2021-12-01,312,66,150,514,5095,826,CHN
2021-12-01,10,1,1,0,0,10,CIV
2021-12-01,77,0,0,0,0,77,CMR
2021-12-01,49,0,0,0,0,49,COD
2021-12-01,77,0,0,0,0,77,COG
2021-12-01,5,0,3,4,0,9,COL
2021-12-01,3,0,5,1,0,4,CUB
2021-12-01,0,0,1,0,0,0,CYP
2021-12-01,21,19,2,27,1501,48,DEU
2021-12-01,1,0,1,0,0,1,DJI
2021-12-01,15,3,1,17,583,32,DNK
2021-12-01,0,0,1,0,0,0,DOM
2021-12-01,0,0,4,0,0,0,DZA
2021-12-01,13,1,2,0,0,13,ECU
2021-12-01,188,4,0,5,0,193,EGY
2021-12-01,0,0,2,1,0,1,ERI
2021-12-01,3,6,0,7,0,10,ESP
2021-12-01,0,0,0,1,0,1,EST
2021-12-01,0,0,0,48,5,48,FIN
2021-12-01,0,0,4,20,42,20,FRA
2021-12-01,122,0,1,1,0,123,GAB
2021-12-01,150,10,2,13,2663,163,GBR
2021-12-01,1,0,0,0,0,1,GEO
2021-12-01,0,0,0,1,0,1,GGY
2021-12-01,3,0,4,2,0,5,GHA
2021-12-01,0,0,3,2,0,2,GIN
2021-12-01,0,0,0,2,0,2,GLP
2021-12-01,0,0,1,8,0,8,GNB
2021-12-01,14,0,0,0,0,14,GNQ
2021-12-01,5,0,0,2,0,7,GRC
2021-12-01,0,0,1,1,0,1,GUY
2021-12-01,15,0,0,3,0,18,HRV
2021-12-01,371,73,75,201,0,572,IDN
2021-12-01,188,3,37,27,0,215,IND
2021-12-01,3,0,1,4,7,7,IRL
2021-12-01,172,4,1,4,0,176,IRN
2021-12-01,1,1,1,10,0,11,IRQ
2021-12-01,0,0,0,5,0,5,ISL
2021-12-01,4,0,1,0,0,4,ISR
2021-12-01,105,8,3,10,0,115,ITA
2021-12-01,0,0,1,1,0,1,JAM
2021-12-01,27,16,43,48,0,75,JPN
2021-12-01,0,0,4,1,0,1,KEN
2021-12-01,4,0,1,4,0,8,KHM
2021-12-01,7,1,81,58,12,65,KOR
2021-12-01,32,4,0,49,0,81,KWT
2021-12-01,0,0,8,1,0,1,LBR
2021-12-01,11,0,1,0,0,11,LBY
2021-12-01,0,0,6,5,0,5,LKA
2021-12-01,1,0,0,0,0,1,LTU
2021-12-01,0,0,1,1,0,1,LVA
2021-12-01,0,0,0,1,0,1,MAR
2021-12-01,0,0,2,1,0,1,MDG
2021-12-01,217,2,11,5,0,222,MEX
2021-12-01,1,0,0,0,0,1,MLT
2021-12-01,5,1,16,13,0,18,MMR
2021-12-01,0,0,1,0,0,0,MNE
2021-12-01,2,0,1,2,0,4,MOZ
2021-12-01,0,0,1,0,0,0,MRT
2021-12-01,339,66,41,86,0,425,MYS
2021-12-01,9,0,0,0,0,9,NAM
2021-12-01,438,5,6,1,0,439,NGA
2021-12-01,0,0,2,1,0,1,NIC
2021-12-01,117,10,1,5,486,122,NLD
2021-12-01,16,0,0,9,2,25,NOR
2021-12-01,6,0,1,4,0,10,NZL
2021-12-01,17,0,13,5,0,22,None
2021-12-01,8,0,2,2,0,10,OMN
2021-12-01,0,0,1,1,0,1,PAK
2021-12-01,0,0,6,5,0,5,PAN
2021-12-01,98,2,2,2,0,100,PER
2021-12-01,7,0,12,37,0,44,PHL
2021-12-01,2,0,0,3,0,5,PNG
2021-12-01,9,3,0,8,3,17,POL
2021-12-01,0,0,5,2,0,2,PRK
2021-12-01,0,0,0,1,0,1,PRT
2021-12-01,181,0,2,5,0,186,QAT
2021-12-01,9,0,0,0,0,9,ROU
2021-12-01,10,1,4,6,0,16,RUS
2021-12-01,758,17,10,1,0,759,SAU
2021-12-01,1,0,2,0,0,1,SDN
2021-12-01,3,0,1,0,0,3,SEN
2021-12-01,0,0,0,32,0,32,SGP
2021-12-01,0,0,1,0,0,0,SLB
2021-12-01,0,0,0,5,0,5,SLE
2021-12-01,0,0,0,1,0,1,SOM
2021-12-01,1,0,3,0,0,1,SUR
2021-12-01,0,0,1,42,65,42,SWE
2021-12-01,419,1,15,85,0,504,THA
2021-12-01,4,0,0,0,0,4,TLS
2021-12-01,322,1,0,1,0,323,TTO
2021-12-01,14,15,1,2,0,16,TUN
2021-12-01,6,1,15,51,0,57,TUR
2021-12-01,20,21,3,0,35,20,TWN
2021-12-01,1,0,1,0,0,1,TZA
2021-12-01,14,4,3,10,0,24,UKR
2021-12-01,0,0,1,0,0,0,URY
2021-12-01,2136,41,2,672,7,2808,USA
2021-12-01,15,3,4,7,0,22,VEN
2021-12-01,44,1,25,292,281,336,VNM
2021-12-01,0,0,1,0,0,0,VUT
2021-12-01,3,0,9,6,0,9,YEM
2021-12-01,1,0,6,0,0,1,ZAF
2022-01-01,2,0,1,0,0,2,ABW
2022-01-01,245,1,0,0,0,245,AGO
2022-01-01,521,0,1,10,0,531,ARE
2022-01-01,0,0,1,0,0,0,ASM
2022-01-01,0,0,1,0,0,0,ATG
2022-01-01,69,4,33,39,0,108,AUS
2022-01-01,0,0,1,5,405,5,BEL
2022-01-01,6,0,0,0,0,6,BEN
2022-01-01,0,0,1,0,0,0,BES
2022-01-01,3,1,0,0,0,3,BGD
2022-01-01,1,0,0,0,0,1,BGR
2022-01-01,7,1,1,0,0,7,BHR
2022-01-01,0,0,2,5,0,5,BHS
2022-01-01,125,12,12,29,0,154,BRA
2022-01-01,132,4,0,0,0,132,BRN
2022-01-01,0,0,7,21,0,21,CAN
2022-01-01,0,0,2,0,0,0,CHL
2022-01-01,303,60,139,449,5088,752,CHN
2022-01-01,10,1,1,0,0,10,CIV
2022-01-01,75,0,0,0,0,75,CMR
2022-01-01,49,0,0,0,0,49,COD
2022-01-01,77,0,0,0,0,77,COG
2022-01-01,5,0,3,3,0,8,COL
2022-01-01,3,0,4,1,0,4,CUB
2022-01-01,0,0,1,0,0,0,CYP
2022-01-01,20,14,2,26,1498,46,DEU
2022-01-01,1,0,1,0,0,1,DJI
2022-01-01,15,1,1,16,580,31,DNK
2022-01-01,0,0,1,0,0,0,DOM
2022-01-01,0,0,4,0,0,0,DZA
2022-01-01,13,1,2,0,0,13,ECU
2022-01-01,181,4,0,5,0,186,EGY
2022-01-01,0,0,2,1,0,1,ERI
2022-01-01,2,5,0,7,0,9,ESP
2022-01-01,0,0,0,1,0,1,EST
2022-01-01,0,0,0,45,5,45,FIN
2022-01-01,0,0,3,18,42,18,FRA
2022-01-01,120,0,1,1,0,121,GAB
2022-01-01,141,8,2,11,2659,152,GBR
2022-01-01,1,0,0,0,0,1,GEO
2022-01-01,2,0,4,2,0,4,GHA
2022-01-01,0,0,3,2,0,2,GIN
2022-01-01,0,0,0,2,0,2,GLP
2022-01-01,0,0,1,5,0,5,GNB
2022-01-01,14,0,0,0,0,14,GNQ
2022-01-01,4,0,0,2,0,6,GRC
2022-01-01,0,0,1,0,0,0,GUY
2022-01-01,15,0,0,3,0,18,HRV
2022-01-01,364,56,70,161,0,525,IDN
2022-01-01,183,2,35,23,0,206,IND
2022-01-01,2,0,1,4,7,6,IRL
2022-01-01,163,3,1,2,0,165,IRN
2022-01-01,1,1,1,7,0,8,IRQ
2022-01-01,0,0,0,4,0,4,ISL
2022-01-01,4,0,1,0,0,4,ISR
2022-01-01,104,8,3,8,0,112,ITA
2022-01-01,0,0,1,1,0,1,JAM
2022-01-01,25,16,41,41,0,66,JPN
2022-01-01,0,0,4,1,0,1,KEN
2022-01-01,4,0,1,4,0,8,KHM
2022-01-01,7,1,80,50,12,57,KOR
2022-01-01,31,4,0,25,0,56,KWT
2022-01-01,0,0,7,1,0,1,LBR
2022-01-01,10,0,1,0,0,10,LBY
2022-01-01,0,0,6,5,0,5,LKA
2022-01-01,1,0,0,0,0,1,LTU
2022-01-01,0,0,1,1,0,1,LVA
2022-01-01,0,0,2,1,0,1,MDG
2022-01-01,211,2,9,4,0,215,MEX
2022-01-01,1,0,0,0,0,1,MLT
2022-01-01,4,1,15,11,0,15,MMR
2022-01-01,0,0,1,0,0,0,MNE
2022-01-01,1,0,1,2,0,3,MOZ
2022-01-01,0,0,1,0,0,0,MRT
2022-01-01,332,60,38,77,0,409,MYS
2022-01-01,8,0,0,0,0,8,NAM
2022-01-01,433,4,6,1,0,434,NGA
2022-01-01,0,0,2,1,0,1,NIC
2022-01-01,114,9,1,5,485,119,NLD
2022-01-01,10,0,0,8,2,18,NOR
2022-01-01,5,0,1,4,0,9,NZL
2022-01-01,15,0,13,5,0,20,None
2022-01-01,8,0,2,2,0,10,OMN
2022-01-01,0,0,1,0,0,0,PAK
2022-01-01,0,0,5,3,0,3,PAN
2022-01-01,97,1,2,1,0,98,PER
2022-01-01,7,0,12,21,0,28,PHL
2022-01-01,2,0,0,3,0,5,PNG
2022-01-01,9,3,0,8,3,17,POL
2022-01-01,0,0,4,2,0,2,PRK
2022-01-01,175,0,2,5,0,180,QAT
2022-01-01,9,0,0,0,0,9,ROU
2022-01-01,9,1,4,5,0,14,RUS
2022-01-01,753,15,10,1,0,754,SAU
2022-01-01,1,0,2,0,0,1,SDN
2022-01-01,2,0,1,0,0,2,SEN
2022-01-01,0,0,0,31,0,31,SGP
2022-01-01,0,0,1,0,0,0,SLB
2022-01-01,0,0,0,5,0,5,SLE
2022-01-01,0,0,0,1,0,1,SOM
2022-01-01,1,0,3,0,0,1,SUR
2022-01-01,0,0,1,41,65,41,SWE
2022-01-01,419,1,14,76,0,495,THA
2022-01-01,4,0,0,0,0,4,TLS
2022-01-01,308,1,0,1,0,309,TTO
2022-01-01,14,15,1,1,0,15,TUN
2022-01-01,6,1,15,50,0,56,TUR
2022-01-01,18,20,3,0,35,18,TWN
2022-01-01,1,0,1,0,0,1,TZA
2022-01-01,13,4,3,8,0,21,UKR
2022-01-01,0,0,1,0,0,0,URY
2022-01-01,2075,38,2,628,7,2703,USA
2022-01-01,12,2,2,3,0,15,VEN
2022-01-01,44,1,24,283,278,327,VNM
2022-01-01,0,0,1,0,0,0,VUT
2022-01-01,2,0,9,6,0,8,YEM
2022-01-01,1,0,4,0,0,1,ZAF